CustomerID,Recency,Frequency,Monetary,R,F,M,RMF,customer_type
12346.0,326,1,77183.6,4,4,1,9,Silver
12347.0,3,182,4310.000000000001,1,1,1,3,Platinum
12348.0,76,31,1797.24,3,3,1,7,Gold
12349.0,19,73,1757.5500000000002,2,2,1,5,Platinum
12350.0,311,17,334.40000000000003,4,4,3,11,Bronze
12352.0,37,85,2506.0400000000004,2,2,1,5,Platinum
12353.0,205,4,89.0,4,4,4,12,Bronze
12354.0,233,58,1079.3999999999999,4,2,2,8,Gold
12355.0,215,13,459.4,4,4,3,11,Bronze
12356.0,23,59,2811.43,2,2,1,5,Platinum
12357.0,34,131,6207.67,2,1,1,4,Platinum
12358.0,2,19,1168.06,1,3,2,6,Gold
12359.0,58,245,6310.030000000001,3,1,1,5,Platinum
12360.0,53,129,2662.06,3,1,1,5,Platinum
12361.0,288,10,189.89999999999998,4,4,4,12,Bronze
12362.0,4,266,5226.23,1,1,1,3,Platinum
12363.0,110,23,552.0,3,3,3,9,Silver
12364.0,8,85,1313.1000000000001,1,2,2,5,Platinum
12365.0,292,22,641.3799999999999,4,3,3,10,Silver
12367.0,5,11,168.89999999999998,1,4,4,9,Silver
12370.0,52,166,3541.94,3,1,1,5,Platinum
12371.0,45,63,1887.96,2,2,1,5,Platinum
12372.0,72,52,1298.0400000000002,3,2,2,7,Gold
12373.0,312,14,364.6,4,4,3,11,Bronze
12374.0,26,33,742.93,2,3,2,7,Gold
12375.0,11,17,457.5,1,4,3,8,Gold
12377.0,316,77,1628.12,4,2,2,8,Gold
12378.0,130,219,4008.62,3,1,1,5,Platinum
12379.0,82,40,852.24,3,3,2,8,Gold
12380.0,22,104,2724.8100000000004,2,1,1,4,Platinum
12381.0,5,87,1845.3100000000004,1,2,1,4,Platinum
12383.0,185,99,1850.5600000000002,4,1,1,6,Gold
12384.0,29,27,585.2700000000001,2,3,3,8,Gold
12386.0,338,10,401.9,4,4,3,11,Bronze
12388.0,16,100,2780.6600000000003,1,1,1,3,Platinum
12390.0,80,32,549.84,3,3,3,9,Silver
12391.0,22,93,439.66,2,2,3,7,Gold
12393.0,73,64,1582.6000000000001,3,2,2,7,Gold
12394.0,64,27,1272.48,3,3,2,8,Gold
12395.0,20,156,3018.63,2,1,1,4,Platinum
12397.0,36,126,2409.9000000000005,2,1,1,4,Platinum
12398.0,46,85,1635.6599999999999,2,2,2,6,Gold
12399.0,120,59,1108.65,3,2,2,7,Gold
12401.0,304,5,84.3,4,4,4,12,Bronze
12402.0,324,11,225.6,4,4,4,12,Bronze
12403.0,50,5,427.7,2,4,3,9,Silver
12405.0,149,54,1710.3900000000003,4,2,1,7,Gold
12406.0,23,105,3415.3,2,1,1,4,Platinum
12407.0,50,77,1708.1199999999997,2,2,1,5,Platinum
12408.0,33,105,2888.55,2,1,1,4,Platinum
12409.0,79,109,11072.67,3,1,1,5,Platinum
12410.0,309,26,693.3299999999999,4,3,2,9,Silver
12412.0,75,61,1226.88,3,2,2,7,Gold
12413.0,67,38,758.1,3,3,2,8,Gold
12414.0,218,18,562.41,4,3,3,10,Silver
12415.0,25,714,124914.53,2,1,1,4,Platinum
12417.0,4,192,3649.1000000000004,1,1,1,3,Platinum
12418.0,113,34,668.58,3,3,2,8,Gold
12420.0,64,29,600.3900000000001,3,3,3,9,Silver
12421.0,16,45,807.0400000000001,1,2,2,5,Platinum
12422.0,96,39,803.5599999999998,3,3,2,8,Gold
12423.0,1,125,1859.31,1,1,1,3,Platinum
12424.0,163,30,1760.9599999999996,4,3,1,8,Gold
12425.0,79,36,777.1999999999999,3,3,2,8,Gold
12426.0,195,30,582.73,4,3,3,10,Silver
12427.0,22,31,825.8,2,3,2,7,Gold
12428.0,26,294,7956.46,2,1,1,4,Platinum
12429.0,10,97,3750.4,1,2,1,4,Platinum
12430.0,44,11,256.4,2,4,4,10,Silver
12431.0,36,234,6419.950000000001,2,1,1,4,Platinum
12432.0,43,108,5059.319999999999,2,1,1,4,Platinum
12433.0,1,420,13375.87,1,1,1,3,Platinum
12434.0,85,50,806.14,3,2,2,7,Gold
12435.0,80,36,7829.890000000001,3,3,1,7,Gold
12436.0,100,16,509.01000000000005,3,4,3,10,Silver
12437.0,2,199,4951.41,1,1,1,3,Platinum
12438.0,15,98,2906.8500000000004,1,2,1,4,Platinum
12441.0,367,11,173.55,4,4,4,12,Bronze
12442.0,4,12,172.06,1,4,4,9,Silver
12444.0,22,176,5005.46,2,1,1,4,Platinum
12445.0,23,4,133.4,2,4,4,10,Silver
12446.0,58,57,1002.3100000000001,3,2,2,7,Gold
12447.0,244,26,476.49,4,3,3,10,Silver
12448.0,45,22,449.4500000000001,2,3,3,8,Gold
12449.0,23,191,4067.2900000000004,2,1,1,4,Platinum
12450.0,157,8,197.88,4,4,4,12,Bronze
12451.0,11,354,9035.52,1,1,1,3,Platinum
12452.0,17,22,430.57,1,3,3,7,Gold
12453.0,135,43,707.0899999999999,3,2,2,7,Gold
12454.0,57,15,3528.34,3,4,1,8,Gold
12455.0,74,90,2466.8599999999997,3,2,1,6,Gold
12456.0,45,125,3181.04,2,1,1,4,Platinum
12457.0,67,62,2363.23,3,2,1,6,Gold
12458.0,72,38,947.4,3,3,2,8,Gold
12461.0,95,35,826.88,3,3,2,8,Gold
12462.0,19,62,1189.5900000000001,2,2,2,6,Gold
12463.0,54,83,1344.7800000000002,3,2,2,7,Gold
12464.0,11,29,1212.05,1,3,2,6,Gold
12465.0,18,47,742.19,1,2,2,5,Platinum
12468.0,188,38,729.54,4,3,2,9,Silver
12471.0,3,459,19788.65,1,1,1,3,Platinum
12472.0,33,339,6572.110000000001,2,1,1,4,Platinum
12473.0,30,167,3928.05,2,1,1,4,Platinum
12474.0,18,422,7324.089999999999,1,1,1,3,Platinum
12475.0,54,36,723.3799999999999,3,3,2,8,Gold
12476.0,16,233,6816.42,1,1,1,3,Platinum
12477.0,23,300,13219.740000000002,2,1,1,4,Platinum
12478.0,4,36,680.9900000000001,1,3,2,6,Gold
12479.0,12,31,527.2,1,3,3,7,Gold
12480.0,29,154,3281.6299999999997,2,1,1,4,Platinum
12481.0,23,216,5579.82,2,1,1,4,Platinum
12483.0,18,75,2484.98,1,2,1,4,Platinum
12484.0,33,343,4527.32,2,1,1,4,Platinum
12488.0,10,55,1298.6600000000003,1,2,2,5,Platinum
12489.0,337,15,334.92999999999995,4,4,3,11,Bronze
12490.0,6,245,5417.93,1,1,1,3,Platinum
12491.0,39,26,460.40000000000003,2,3,3,8,Gold
12492.0,64,20,263.21,3,3,4,10,Silver
12493.0,166,22,433.74,4,3,3,10,Silver
12494.0,16,77,1246.1,1,2,2,5,Platinum
12497.0,82,14,1043.1,3,4,2,9,Silver
12498.0,22,23,403.7,2,3,3,8,Gold
12500.0,24,61,4257.820000000001,2,2,1,5,Platinum
12501.0,337,149,2169.3900000000003,4,1,1,6,Gold
12502.0,96,147,3723.87,3,1,1,5,Platinum
12504.0,19,9,482.04999999999995,2,4,3,9,Silver
12506.0,233,23,73.50000000000001,4,3,4,11,Bronze
12507.0,135,21,1304.81,3,3,2,8,Gold
12508.0,27,68,397.88,2,2,3,7,Gold
12509.0,285,7,176.5,4,4,4,12,Bronze
12510.0,143,33,982.5699999999999,4,3,2,9,Silver
12512.0,67,31,132.18,3,3,4,10,Silver
12513.0,113,35,612.2900000000001,3,3,3,9,Silver
12514.0,268,51,1017.6800000000001,4,2,2,8,Gold
12515.0,354,16,383.70000000000005,4,4,3,11,Bronze
12516.0,78,26,1312.06,3,3,2,8,Gold
12517.0,29,279,2481.6,2,1,1,4,Platinum
12518.0,1,124,2056.89,1,1,1,3,Platinum
12519.0,64,17,330.84000000000003,3,4,3,10,Silver
12520.0,80,152,2634.26,3,1,1,5,Platinum
12521.0,143,38,599.68,4,3,3,10,Silver
12522.0,40,12,192.72000000000003,2,4,4,10,Silver
12523.0,20,106,1789.77,2,1,1,4,Platinum
12524.0,10,144,4485.719999999999,1,1,1,3,Platinum
12526.0,1,71,1316.6600000000003,1,2,2,5,Platinum
12527.0,82,18,348.71000000000004,3,3,3,9,Silver
12528.0,10,92,1933.4800000000002,1,2,1,4,Platinum
12530.0,60,66,1662.28,3,2,1,6,Gold
12531.0,15,17,125.22,1,4,4,9,Silver
12532.0,31,16,349.83000000000004,2,4,3,9,Silver
12534.0,131,63,1089.18,3,2,2,7,Gold
12535.0,92,34,716.35,3,3,2,8,Gold
12536.0,44,261,12601.830000000002,2,1,1,4,Platinum
12538.0,30,21,363.95,2,3,3,8,Gold
12539.0,23,273,5568.349999999999,2,1,1,4,Platinum
12540.0,20,478,13400.24,2,1,1,4,Platinum
12541.0,30,52,981.1800000000002,2,2,2,6,Gold
12544.0,37,19,372.70000000000005,2,3,3,8,Gold
12545.0,76,50,1000.39,3,2,2,7,Gold
12546.0,47,69,1161.5,2,2,2,6,Gold
12547.0,198,8,207.8,4,4,4,12,Bronze
12548.0,167,5,95.19999999999999,4,4,4,12,Bronze
12550.0,80,57,964.83,3,2,2,7,Gold
12551.0,358,10,168.0,4,4,4,12,Bronze
12552.0,39,20,437.82,2,3,3,8,Gold
12553.0,9,191,3692.2799999999997,1,1,1,3,Platinum
12556.0,51,119,599.56,2,1,3,6,Gold
12557.0,17,33,11990.96,1,3,1,5,Platinum
12558.0,8,11,269.96000000000004,1,4,4,9,Silver
12559.0,311,21,561.7099999999999,4,3,3,10,Silver
12560.0,6,105,2134.01,1,1,1,3,Platinum
12561.0,303,16,238.85,4,4,4,12,Bronze
12562.0,9,168,3781.74,1,1,1,3,Platinum
12564.0,262,21,456.90000000000003,4,3,3,10,Silver
12565.0,289,9,145.92000000000002,4,4,4,12,Bronze
12566.0,87,19,351.65,3,3,3,9,Silver
12567.0,23,446,9401.279999999999,2,1,1,4,Platinum
12569.0,3,188,4124.6900000000005,1,1,1,3,Platinum
12571.0,40,34,519.61,2,3,3,8,Gold
12572.0,9,60,1020.42,1,2,2,5,Platinum
12573.0,228,28,160.54,4,3,4,11,Bronze
12574.0,316,11,218.45000000000002,4,4,4,12,Bronze
12576.0,36,88,1315.83,2,2,2,6,Gold
12577.0,36,146,626.5999999999999,2,1,3,6,Gold
12578.0,22,114,2794.5099999999998,2,1,1,4,Platinum
12579.0,79,29,440.41999999999996,3,3,3,9,Silver
12580.0,247,24,415.70000000000005,4,3,3,10,Silver
12581.0,40,15,197.70999999999998,2,4,4,10,Silver
12582.0,239,22,511.3599999999999,4,3,3,10,Silver
12583.0,3,247,7281.379999999999,1,1,1,3,Platinum
12584.0,4,96,2338.1500000000005,1,2,1,4,Platinum
12585.0,235,87,2040.0999999999997,4,2,1,7,Gold
12586.0,18,11,196.94000000000003,1,4,4,9,Silver
12587.0,8,4,144.0,1,4,4,9,Silver
12588.0,40,10,214.89999999999998,2,4,4,10,Silver
12589.0,29,35,646.6800000000001,2,3,3,8,Gold
12590.0,212,68,9864.26,4,2,1,7,Gold
12591.0,318,26,452.84999999999997,4,3,3,10,Silver
12592.0,93,18,437.6,3,3,3,9,Silver
12593.0,109,21,418.0999999999999,3,3,3,9,Silver
12594.0,38,118,3338.2200000000003,2,1,1,4,Platinum
12596.0,52,27,618.27,3,3,3,9,Silver
12597.0,20,206,3811.2199999999993,2,1,1,4,Platinum
12598.0,10,132,3023.08,1,1,1,3,Platinum
12599.0,30,62,1032.5800000000004,2,2,2,6,Gold
12600.0,29,64,2599.04,2,2,1,5,Platinum
12601.0,190,28,577.0600000000001,4,3,3,10,Silver
12602.0,59,12,153.12,3,4,4,11,Bronze
12603.0,22,2,739.1999999999999,2,4,2,8,Gold
12604.0,80,16,254.17999999999998,3,4,4,11,Bronze
12607.0,61,101,1579.51,3,1,2,6,Gold
12609.0,79,60,1126.8500000000001,3,2,2,7,Gold
12610.0,23,106,2099.54,2,1,1,4,Platinum
12611.0,53,65,1193.32,3,2,2,7,Gold
12612.0,75,19,704.04,3,3,2,8,Gold
12613.0,58,153,3344.38,3,1,1,5,Platinum
12614.0,278,20,315.59999999999997,4,3,3,10,Silver
12615.0,3,105,2291.1899999999996,1,1,1,3,Platinum
12616.0,96,32,713.3,3,3,2,8,Gold
12617.0,30,41,352.97999999999996,2,3,3,8,Gold
12618.0,22,11,177.31,2,4,4,10,Silver
12619.0,17,90,3641.24,1,2,1,4,Platinum
12620.0,15,92,1339.41,1,2,2,5,Platinum
12621.0,2,467,13689.67,1,1,1,3,Platinum
12622.0,233,11,180.09999999999997,4,4,4,12,Bronze
12623.0,277,18,305.1,4,3,4,11,Bronze
12624.0,107,38,641.13,3,3,3,9,Silver
12625.0,212,86,2683.82,4,2,1,7,Gold
12626.0,24,294,6620.48,2,1,1,4,Platinum
12627.0,11,230,4478.530000000001,1,1,1,3,Platinum
12628.0,5,41,786.4599999999999,1,3,2,6,Gold
12630.0,10,64,1270.88,1,2,2,5,Platinum
12631.0,58,31,640.5,3,3,3,9,Silver
12633.0,59,101,2163.98,3,1,1,5,Platinum
12635.0,90,101,1689.1800000000003,3,1,1,5,Platinum
12637.0,68,382,6002.9,3,1,1,5,Platinum
12638.0,34,39,671.69,2,3,2,7,Gold
12639.0,239,22,486.1,4,3,3,10,Silver
12640.0,24,53,1174.58,2,2,2,6,Gold
12641.0,116,10,185.9,3,4,4,11,Bronze
12642.0,26,47,1013.26,2,2,2,6,Gold
12643.0,129,24,3344.6399999999994,3,3,1,7,Gold
12644.0,130,31,477.90999999999997,3,3,3,9,Silver
12645.0,34,73,1775.1800000000003,2,2,1,5,Platinum
12646.0,5,45,1346.97,1,2,2,5,Platinum
12647.0,23,121,3722.82,2,1,1,4,Platinum
12648.0,155,21,318.04999999999995,4,3,3,10,Silver
12649.0,108,31,623.51,3,3,3,9,Silver
12650.0,4,20,314.44,1,3,3,7,Gold
12651.0,335,9,114.0,4,4,4,12,Bronze
12652.0,332,48,919.98,4,2,2,8,Gold
12653.0,149,43,2209.85,4,2,1,7,Gold
12654.0,11,38,601.9799999999999,1,3,3,7,Gold
12656.0,18,126,4051.17,1,1,1,3,Platinum
12657.0,12,47,1643.18,1,2,2,5,Platinum
12658.0,19,36,686.05,2,3,2,7,Gold
12659.0,30,5,91.68,2,4,4,10,Silver
12660.0,12,13,245.10000000000002,1,4,4,9,Silver
12662.0,1,230,3849.7799999999997,1,1,1,3,Platinum
12664.0,9,37,4881.88,1,3,1,5,Platinum
12665.0,325,3,63.0,4,4,4,12,Bronze
12667.0,59,33,620.1300000000001,3,3,3,9,Silver
12668.0,12,161,3807.15,1,1,1,3,Platinum
12669.0,151,101,2744.03,4,1,1,6,Gold
12670.0,11,92,2996.0500000000006,1,2,1,4,Platinum
12672.0,330,10,225.9,4,4,4,12,Bronze
12673.0,6,42,610.52,1,2,3,6,Gold
12674.0,39,83,1970.6000000000001,2,2,1,5,Platinum
12676.0,25,45,1331.39,2,2,2,6,Gold
12678.0,43,165,17628.46,2,1,1,4,Platinum
12679.0,59,48,1113.02,3,2,2,7,Gold
12680.0,1,52,862.8100000000002,1,2,2,5,Platinum
12681.0,15,638,13787.54,1,1,1,3,Platinum
12682.0,4,524,12279.82,1,1,1,3,Platinum
12683.0,5,344,8476.57,1,1,1,3,Platinum
12684.0,8,105,2283.63,1,1,1,3,Platinum
12685.0,29,157,2863.08,2,1,1,4,Platinum
12686.0,372,7,89.14,4,4,4,12,Bronze
12688.0,114,171,4873.8099999999995,3,1,1,5,Platinum
12689.0,26,72,1247.61,2,2,2,6,Gold
12690.0,206,16,389.01,4,4,3,11,Bronze
12691.0,29,32,1035.8,2,3,2,7,Gold
12693.0,128,39,855.91,3,3,2,8,Gold
12694.0,71,37,869.67,3,3,2,8,Gold
12695.0,8,27,582.1,1,3,3,7,Gold
12697.0,29,41,957.5899999999999,2,3,2,7,Gold
12700.0,8,268,4939.99,1,1,1,3,Platinum
12701.0,80,53,797.71,3,2,2,7,Gold
12702.0,20,12,219.0,2,4,4,10,Silver
12703.0,72,21,283.55,3,3,4,10,Silver
12704.0,8,88,2340.8399999999997,1,2,1,4,Platinum
12705.0,16,334,6868.290000000001,1,1,1,3,Platinum
12707.0,292,33,603.42,4,3,3,10,Silver
12708.0,30,157,2712.91,2,1,1,4,Platinum
12709.0,16,207,9706.52,1,1,1,3,Platinum
12710.0,97,77,1149.0200000000002,3,2,2,7,Gold
12712.0,29,133,4396.13,2,1,1,4,Platinum
12713.0,1,38,848.5500000000001,1,3,2,6,Gold
12714.0,10,259,4708.860000000001,1,1,1,3,Platinum
12715.0,107,20,343.35999999999996,3,3,3,9,Silver
12716.0,4,69,1053.4900000000002,1,2,2,5,Platinum
12717.0,152,55,1030.98,4,2,2,8,Gold
12718.0,72,19,238.25,3,3,4,10,Silver
12719.0,6,39,644.95,1,3,3,7,Gold
12720.0,3,354,5781.730000000001,1,1,1,3,Platinum
12721.0,32,161,2656.13,2,1,1,4,Platinum
12722.0,86,53,997.6300000000001,3,2,2,7,Gold
12723.0,4,69,725.07,1,2,2,5,Platinum
12724.0,6,53,1031.4099999999999,1,2,2,5,Platinum
12725.0,372,24,427.8,4,3,3,10,Silver
12726.0,29,124,2609.1,2,1,1,4,Platinum
12727.0,11,139,3980.7000000000003,1,1,1,3,Platinum
12728.0,72,46,836.3299999999999,3,2,2,7,Gold
12729.0,114,26,453.01000000000005,3,3,3,9,Silver
12731.0,24,274,18895.91,2,1,1,4,Platinum
12732.0,180,12,236.26000000000005,4,4,4,12,Bronze
12733.0,235,22,383.95000000000005,4,3,3,10,Silver
12734.0,353,4,110.39999999999999,4,4,4,12,Bronze
12735.0,316,43,779.57,4,2,2,8,Gold
12736.0,333,4,234.00000000000003,4,4,4,12,Bronze
12738.0,373,11,155.35,4,4,4,12,Bronze
12739.0,79,38,1013.0400000000001,3,3,2,8,Gold
12740.0,64,27,427.59999999999997,3,3,3,9,Silver
12743.0,135,131,540.13,3,1,3,7,Gold
12744.0,52,222,21279.29,3,1,1,5,Platinum
12747.0,3,103,4196.009999999999,1,1,1,3,Platinum
12748.0,1,4412,33053.19,1,1,1,3,Platinum
12749.0,4,199,4090.88,1,1,1,3,Platinum
12750.0,129,15,275.88,3,4,4,11,Bronze
12752.0,82,53,4366.780000000001,3,2,1,6,Gold
12753.0,23,197,21429.39,2,1,1,4,Platinum
12754.0,236,63,3010.7400000000002,4,2,1,7,Gold
12755.0,281,4,3811.9499999999994,4,4,1,9,Silver
12756.0,87,4,112.08000000000001,3,4,4,11,Bronze
12757.0,16,364,7834.650000000001,1,1,1,3,Platinum
12758.0,117,97,2791.59,3,2,1,6,Gold
12759.0,53,95,1531.4400000000003,3,2,2,7,Gold
12762.0,8,69,1898.5200000000004,1,2,1,4,Platinum
12763.0,139,18,494.08000000000004,3,3,3,9,Silver
12764.0,317,45,1693.88,4,2,1,7,Gold
12766.0,4,310,6989.63,1,1,1,3,Platinum
12769.0,239,32,1143.6,4,3,2,9,Silver
12770.0,211,12,1351.4499999999998,4,4,2,10,Silver
12772.0,60,55,892.4700000000001,3,2,2,7,Gold
12775.0,18,66,1386.0400000000002,1,2,2,5,Platinum
12778.0,20,50,822.23,2,2,2,6,Gold
12779.0,38,149,3981.3599999999997,2,1,1,4,Platinum
12781.0,64,25,826.74,3,3,2,8,Gold
12782.0,5,103,2330.9200000000005,1,1,1,3,Platinum
12783.0,3,84,2225.91,1,2,1,4,Platinum
12784.0,10,57,532.8199999999999,1,2,3,6,Gold
12785.0,365,14,311.95,4,4,3,11,Bronze
12787.0,10,20,463.65999999999997,1,3,3,7,Gold
12789.0,66,4,91.85000000000001,3,4,4,11,Bronze
12790.0,193,21,324.9200000000001,4,3,3,10,Silver
12791.0,374,2,192.60000000000002,4,4,4,12,Bronze
12792.0,257,25,400.53999999999996,4,3,3,10,Silver
12793.0,335,24,545.48,4,3,3,10,Silver
12794.0,54,45,860.41,3,2,2,7,Gold
12795.0,19,14,430.48,2,4,3,9,Silver
12797.0,366,13,254.03,4,4,4,12,Bronze
12798.0,11,8,6977.04,1,4,1,6,Gold
12802.0,187,25,427.58,4,3,3,10,Silver
12808.0,37,28,483.65000000000003,2,3,3,8,Gold
12809.0,178,25,489.31,4,3,3,10,Silver
12811.0,261,31,514.8499999999999,4,3,3,10,Silver
12812.0,45,15,229.64,2,4,4,10,Silver
12814.0,102,2,125.92,3,4,4,11,Bronze
12815.0,148,47,1063.46,4,2,2,8,Gold
12816.0,96,29,572.2,3,3,3,9,Silver
12817.0,282,4,166.04,4,4,4,12,Bronze
12818.0,262,14,1542.08,4,4,2,10,Silver
12820.0,4,59,942.34,1,2,2,5,Platinum
12821.0,215,6,92.72,4,4,4,12,Bronze
12822.0,71,46,948.8800000000002,3,2,2,7,Gold
12823.0,75,5,1759.5,3,4,1,8,Gold
12824.0,60,25,397.11999999999995,3,3,3,9,Silver
12826.0,3,91,1474.72,1,2,2,5,Platinum
12827.0,6,25,430.15,1,3,3,7,Gold
12828.0,3,56,1018.71,1,2,2,5,Platinum
12829.0,337,11,293.0,4,4,4,12,Bronze
12830.0,38,38,6814.640000000001,2,3,1,6,Gold
12831.0,263,9,215.05,4,4,4,12,Bronze
12832.0,33,27,383.03000000000003,2,3,3,8,Gold
12833.0,146,24,417.38,4,3,3,10,Silver
12834.0,283,18,312.38,4,3,3,10,Silver
12836.0,60,174,2610.3599999999997,3,1,1,5,Platinum
12837.0,174,12,134.1,4,4,4,12,Bronze
12838.0,34,120,671.95,2,1,2,5,Platinum
12839.0,3,314,5591.42,1,1,1,3,Platinum
12840.0,144,113,2726.77,4,1,1,6,Gold
12841.0,5,414,3991.5800000000004,1,1,1,3,Platinum
12842.0,71,34,1118.99,3,3,2,8,Gold
12843.0,66,103,1702.2600000000002,3,1,1,5,Platinum
12844.0,30,52,325.96,2,2,3,7,Gold
12845.0,268,27,354.09,4,3,3,10,Silver
12847.0,23,84,843.6399999999999,2,2,2,6,Gold
12849.0,32,48,1010.2900000000001,2,2,2,6,Gold
12851.0,97,47,131.80999999999997,3,2,4,9,Silver
12852.0,295,17,311.55,4,4,3,11,Bronze
12853.0,135,78,1957.1000000000004,3,2,1,6,Gold
12854.0,79,109,1316.2500000000002,3,1,2,6,Gold
12855.0,373,3,38.1,4,4,4,12,Bronze
12856.0,8,311,2170.7799999999997,1,1,1,3,Platinum
12857.0,211,46,1106.4,4,2,2,8,Gold
12863.0,53,5,521.2,3,4,3,10,Silver
12864.0,139,3,147.12,3,4,4,11,Bronze
12865.0,27,95,1568.23,2,2,2,6,Gold
12866.0,284,26,559.12,4,3,3,10,Silver
12867.0,27,534,4009.3399999999997,2,1,1,4,Platinum
12868.0,186,107,1607.0600000000002,4,1,2,7,Gold
12871.0,85,11,380.64000000000004,3,4,3,10,Silver
12872.0,327,66,599.9700000000001,4,2,3,9,Silver
12873.0,283,4,374.0,4,4,3,11,Bronze
12875.0,144,2,343.2300000000001,4,4,3,11,Bronze
12876.0,58,85,2218.020000000001,3,2,1,6,Gold
12877.0,4,154,1535.7700000000002,1,1,2,4,Platinum
12878.0,237,47,854.99,4,2,2,8,Gold
12879.0,45,10,573.22,2,4,3,9,Silver
12881.0,276,7,298.0,4,4,4,12,Bronze
12882.0,10,13,1463.0399999999997,1,4,2,7,Gold
12883.0,25,42,703.47,2,2,2,6,Gold
12884.0,89,7,309.05000000000007,3,4,3,10,Silver
12885.0,64,71,1175.2199999999998,3,2,2,7,Gold
12886.0,68,82,1378.3999999999999,3,2,2,7,Gold
12888.0,215,5,354.12,4,4,3,11,Bronze
12890.0,25,79,376.71999999999997,2,2,3,7,Gold
12891.0,186,3,331.0,4,4,3,11,Bronze
12893.0,31,31,176.54999999999998,2,3,4,9,Silver
12895.0,43,22,372.8,2,3,3,8,Gold
12897.0,205,4,216.5,4,4,4,12,Bronze
12901.0,9,116,17654.539999999997,1,1,1,3,Platinum
12902.0,265,10,138.67999999999998,4,4,4,12,Bronze
12904.0,19,71,496.06,2,2,3,7,Gold
12906.0,12,63,2919.81,1,2,1,4,Platinum
12908.0,177,2,750.0,4,4,2,10,Silver
12909.0,40,91,2178.67,2,2,1,5,Platinum
12910.0,24,75,3075.0400000000004,2,2,1,5,Platinum
12912.0,3,24,1662.3,1,3,1,5,Platinum
12913.0,5,50,2483.6299999999997,1,2,1,4,Platinum
12915.0,149,22,363.65,4,3,3,10,Silver
12916.0,139,103,2944.95,3,1,1,5,Platinum
12917.0,129,2,594.0,3,4,3,10,Silver
12919.0,9,50,1335.19,1,2,2,5,Platinum
12920.0,18,27,162.77999999999997,1,3,4,8,Gold
12921.0,10,720,16587.09,1,1,1,3,Platinum
12922.0,162,28,405.38,4,3,3,10,Silver
12923.0,65,28,172.81999999999996,3,3,4,10,Silver
12924.0,89,30,933.7000000000002,3,3,2,8,Gold
12925.0,5,45,694.05,1,2,2,5,Platinum
12928.0,36,84,2062.7,2,2,1,5,Platinum
12929.0,312,8,117.85,4,4,4,12,Bronze
12930.0,79,25,415.8,3,3,3,9,Silver
12931.0,22,82,42055.96,2,2,1,5,Platinum
12933.0,25,106,607.53,2,1,3,6,Gold
12935.0,3,129,2160.7,1,1,1,3,Platinum
12936.0,18,62,1063.8999999999999,1,2,2,5,Platinum
12937.0,16,120,1504.2700000000002,1,1,2,4,Platinum
12938.0,26,9,114.13999999999999,2,4,4,10,Silver
12939.0,65,47,11581.800000000001,3,2,1,6,Gold
12940.0,55,96,899.69,3,2,2,7,Gold
12942.0,132,70,675.6,3,2,2,7,Gold
12944.0,36,30,604.5099999999999,2,3,3,8,Gold
12945.0,289,23,462.95000000000005,4,3,3,10,Silver
12947.0,144,97,1603.99,4,2,2,8,Gold
12948.0,17,116,2064.95,1,1,1,3,Platinum
12949.0,31,215,4167.22,2,1,1,4,Platinum
12950.0,3,23,1843.0,1,3,1,5,Platinum
12951.0,9,63,1064.07,1,2,2,5,Platinum
12952.0,6,79,1387.79,1,2,2,5,Platinum
12953.0,10,17,329.85,1,4,3,8,Gold
12955.0,2,180,4757.160000000001,1,1,1,3,Platinum
12956.0,307,19,108.07,4,3,4,11,Bronze
12957.0,10,238,4017.54,1,1,1,3,Platinum
12962.0,8,16,266.39,1,4,4,9,Silver
12963.0,9,95,1856.63,1,2,1,4,Platinum
12965.0,90,108,769.8100000000001,3,1,2,6,Gold
12966.0,10,10,160.18,1,4,4,9,Silver
12967.0,359,19,1660.9,4,3,1,8,Gold
12968.0,113,5,135.95,3,4,4,11,Bronze
12970.0,8,129,405.47,1,1,3,5,Platinum
12971.0,4,305,11189.91,1,1,1,3,Platinum
12974.0,198,8,144.8,4,4,4,12,Bronze
12976.0,212,22,738.6,4,3,2,9,Silver
12977.0,157,9,39.24,4,4,4,12,Bronze
12980.0,158,20,7374.9,4,3,1,8,Gold
12981.0,30,20,372.2199999999999,2,3,3,8,Gold
12982.0,243,28,390.53999999999996,4,3,3,10,Silver
12984.0,19,4,97.5,2,4,4,10,Silver
12985.0,1,76,1239.3799999999999,1,2,2,5,Platinum
12987.0,74,28,558.7,3,3,3,9,Silver
12988.0,293,83,505.82000000000005,4,2,3,9,Silver
12989.0,4,64,6924.110000000001,1,2,1,4,Platinum
12990.0,32,13,409.5000000000001,2,4,3,9,Silver
12991.0,24,31,503.76000000000005,2,3,3,8,Gold
12993.0,24,27,414.75999999999993,2,3,3,8,Gold
12994.0,5,61,974.42,1,2,2,5,Platinum
12995.0,86,3,211.32,3,4,4,11,Bronze
12997.0,23,59,1226.89,2,2,2,6,Gold
12999.0,197,28,455.88,4,3,3,10,Silver
13000.0,107,31,534.8500000000001,3,3,3,9,Silver
13001.0,5,337,9785.970000000001,1,1,1,3,Platinum
13002.0,319,7,120.94999999999999,4,4,4,12,Bronze
13003.0,106,6,149.05,3,4,4,11,Bronze
13004.0,12,404,5655.91,1,1,1,3,Platinum
13005.0,174,26,513.6999999999999,4,3,3,10,Silver
13006.0,57,4,81.57,3,4,4,11,Bronze
13008.0,324,14,229.47000000000003,4,4,4,12,Bronze
13011.0,373,3,50.550000000000004,4,4,4,12,Bronze
13012.0,10,88,1646.84,1,2,2,5,Platinum
13013.0,2,219,4810.94,1,1,1,3,Platinum
13014.0,11,109,3466.2799999999997,1,1,1,3,Platinum
13015.0,54,175,3339.6400000000003,3,1,1,5,Platinum
13016.0,74,47,789.8899999999999,3,2,2,7,Gold
13017.0,8,1,204.0,1,4,4,9,Silver
13018.0,17,458,7277.700000000001,1,1,1,3,Platinum
13021.0,5,131,2616.38,1,1,1,3,Platinum
13023.0,65,40,689.9000000000001,3,3,2,8,Gold
13026.0,2,40,975.36,1,3,2,6,Gold
13027.0,114,26,6912.0,3,3,1,7,Gold
13028.0,23,45,661.3200000000002,2,2,3,7,Gold
13029.0,31,10,1247.5,2,4,2,8,Gold
13030.0,12,92,752.4399999999999,1,2,2,5,Platinum
13032.0,53,71,1010.1800000000002,3,2,2,7,Gold
13033.0,358,11,190.54999999999998,4,4,4,12,Bronze
13034.0,55,37,642.7700000000001,3,3,3,9,Silver
13035.0,74,27,921.88,3,3,2,8,Gold
13037.0,139,48,881.07,3,2,2,7,Gold
13038.0,81,28,908.46,3,3,2,8,Gold
13040.0,9,43,676.99,1,2,2,5,Platinum
13043.0,274,13,516.4200000000001,4,4,3,11,Bronze
13044.0,292,33,560.47,4,3,3,10,Silver
13045.0,100,18,305.28,3,3,4,10,Silver
13046.0,31,35,629.31,2,3,3,8,Gold
13047.0,32,172,3237.54,2,1,1,4,Platinum
13048.0,15,135,1819.4099999999999,1,1,1,3,Platinum
13049.0,65,14,656.6800000000002,3,4,3,10,Silver
13050.0,15,403,5836.860000000001,1,1,1,3,Platinum
13052.0,213,18,348.15000000000003,4,3,3,10,Silver
13055.0,79,76,1214.41,3,2,2,7,Gold
13058.0,25,8,271.4,2,4,4,10,Silver
13059.0,250,8,183.4,4,4,4,12,Bronze
13060.0,254,15,307.53000000000003,4,4,3,11,Bronze
13061.0,73,10,248.61,3,4,4,11,Bronze
13062.0,192,11,346.98,4,4,3,11,Bronze
13064.0,13,68,1105.5900000000001,1,2,2,5,Platinum
13065.0,374,14,205.85999999999999,4,4,4,12,Bronze
13066.0,25,48,470.79999999999995,2,2,3,7,Gold
13067.0,83,15,115.46000000000001,3,4,4,11,Bronze
13068.0,11,2,344.0,1,4,3,8,Gold
13069.0,1,424,4431.4400000000005,1,1,1,3,Platinum
13070.0,193,9,228.8,4,4,4,12,Bronze
13072.0,267,7,177.14999999999998,4,4,4,12,Bronze
13075.0,130,22,919.6100000000001,3,3,2,8,Gold
13077.0,2,111,728.0200000000001,1,1,2,4,Platinum
13078.0,4,358,12627.939999999999,1,1,1,3,Platinum
13079.0,5,6,220.09999999999997,1,4,4,9,Silver
13080.0,180,6,58.08,4,4,4,12,Bronze
13081.0,12,1024,28337.379999999997,1,1,1,3,Platinum
13082.0,127,73,3613.6299999999997,3,2,1,6,Gold
13083.0,5,18,303.75,1,3,4,8,Gold
13085.0,158,22,416.08000000000004,4,3,3,10,Silver
13089.0,3,1814,58762.08,1,1,1,3,Platinum
13090.0,9,155,8910.819999999998,1,1,1,3,Platinum
13091.0,29,21,345.82000000000005,2,3,3,8,Gold
13092.0,71,25,477.83000000000004,3,3,3,9,Silver
13093.0,276,159,7832.470000000001,4,1,1,6,Gold
13094.0,22,24,1927.3200000000002,2,3,1,6,Gold
13095.0,71,6,74.4,3,4,4,11,Bronze
13097.0,33,421,6003.22,2,1,1,4,Platinum
13098.0,2,572,28882.44,1,1,1,3,Platinum
13099.0,100,1,207.35999999999999,3,4,4,11,Bronze
13101.0,235,8,101.19,4,4,4,12,Bronze
13102.0,2,304,6424.089999999999,1,1,1,3,Platinum
13103.0,40,8,243.94,2,4,4,10,Silver
13104.0,4,20,1098.48,1,3,2,6,Gold
13106.0,134,1,76.5,3,4,4,11,Bronze
13107.0,45,58,1531.6200000000003,2,2,2,6,Gold
13108.0,373,10,350.05999999999995,4,4,3,11,Bronze
13109.0,60,47,786.54,3,2,2,7,Gold
13110.0,32,145,1488.67,2,1,2,5,Platinum
13113.0,1,200,12245.96,1,1,1,3,Platinum
13115.0,12,120,2294.7799999999997,1,1,1,3,Platinum
13116.0,139,30,501.14,3,3,3,9,Silver
13117.0,22,76,984.9100000000001,2,2,2,6,Gold
13118.0,20,79,1197.81,2,2,2,6,Gold
13120.0,239,1,30.599999999999998,4,4,4,12,Bronze
13121.0,270,50,283.72999999999996,4,2,4,10,Silver
13122.0,95,55,922.39,3,2,2,7,Gold
13124.0,90,222,3756.33,3,1,1,5,Platinum
13126.0,5,140,2099.64,1,1,1,3,Platinum
13127.0,78,15,259.16999999999996,3,4,4,11,Bronze
13130.0,95,2,64.0,3,4,4,11,Bronze
13131.0,24,44,1073.2999999999997,2,2,2,6,Gold
13132.0,262,3,77.3,4,4,4,12,Bronze
13133.0,274,7,109.80000000000001,4,4,4,12,Bronze
13134.0,86,98,1793.5800000000002,3,2,1,6,Gold
13135.0,197,1,3096.0,4,4,1,9,Silver
13136.0,57,127,2607.6099999999997,3,1,1,5,Platinum
13137.0,11,687,3603.29,1,1,1,3,Platinum
13138.0,23,63,962.39,2,2,2,6,Gold
13139.0,17,170,5064.9400000000005,1,1,1,3,Platinum
13140.0,109,45,422.47,3,2,3,8,Gold
13141.0,85,135,2388.75,3,1,1,5,Platinum
13142.0,20,23,307.0899999999999,2,3,3,8,Gold
13144.0,333,3,110.94999999999999,4,4,4,12,Bronze
13145.0,40,6,618.52,2,4,3,9,Silver
13146.0,27,17,228.91,2,4,4,10,Silver
13147.0,11,4,712.8000000000001,1,4,2,7,Gold
13148.0,30,312,3683.26,2,1,1,4,Platinum
13149.0,15,86,1676.0600000000002,1,2,1,4,Platinum
13151.0,296,74,1257.8700000000003,4,2,2,8,Gold
13153.0,6,15,486.22,1,4,3,8,Gold
13155.0,34,85,971.7600000000002,2,2,2,6,Gold
13157.0,50,87,1741.2199999999998,2,2,1,5,Platinum
13158.0,95,79,1201.06,3,2,2,7,Gold
13159.0,9,120,1429.3500000000001,1,1,2,4,Platinum
13160.0,23,4,91.8,2,4,4,10,Silver
13161.0,314,8,112.75,4,4,4,12,Bronze
13162.0,123,79,1688.2899999999997,3,2,1,6,Gold
13165.0,47,42,1021.48,2,2,2,6,Gold
13166.0,284,41,417.20000000000005,4,3,3,10,Silver
13167.0,19,65,791.3299999999999,2,2,2,6,Gold
13168.0,37,126,1299.5900000000001,2,1,2,5,Platinum
13169.0,64,13,712.88,3,4,2,9,Silver
13170.0,27,30,108.81,2,3,4,9,Silver
13171.0,22,46,468.40999999999997,2,2,3,7,Gold
13173.0,5,43,353.65000000000003,1,2,3,6,Gold
13174.0,17,293,2742.8200000000006,1,1,1,3,Platinum
13176.0,47,67,481.49000000000007,2,2,3,7,Gold
13177.0,65,17,282.45,3,4,4,11,Bronze
13178.0,27,265,5725.469999999999,2,1,1,4,Platinum
13182.0,46,11,121.18,2,4,4,10,Silver
13183.0,8,94,3957.7800000000007,1,2,1,4,Platinum
13184.0,15,179,1668.95,1,1,1,3,Platinum
13185.0,268,1,71.4,4,4,4,12,Bronze
13186.0,40,79,1575.89,2,2,2,6,Gold
13187.0,338,37,236.01999999999998,4,3,4,11,Bronze
13188.0,12,2,114.60000000000001,1,4,4,9,Silver
13189.0,19,29,260.67999999999995,2,3,4,9,Silver
13192.0,96,63,911.9400000000002,3,2,2,7,Gold
13193.0,62,25,112.08,3,3,4,10,Silver
13194.0,136,3,60.7,3,4,4,11,Bronze
13196.0,12,110,1797.78,1,1,1,3,Platinum
13198.0,11,226,3401.24,1,1,1,3,Platinum
13199.0,4,119,9817.119999999999,1,1,1,3,Platinum
13200.0,20,46,870.0900000000001,2,2,2,6,Gold
13203.0,10,57,869.4599999999999,1,2,2,5,Platinum
13207.0,16,8,250.26000000000002,1,4,4,9,Silver
13208.0,59,148,1217.6499999999999,3,1,2,6,Gold
13209.0,31,321,5891.61,2,1,1,4,Platinum
13210.0,94,22,353.48,3,3,3,9,Silver
13211.0,11,55,1095.4199999999996,1,2,2,5,Platinum
13212.0,20,141,786.83,2,1,2,5,Platinum
13213.0,57,90,1520.58,3,2,2,7,Gold
13216.0,268,5,333.74,4,4,3,11,Bronze
13217.0,123,4,533.98,3,4,3,10,Silver
13218.0,128,5,62.64,3,4,4,11,Bronze
13220.0,79,21,819.29,3,3,2,8,Gold
13221.0,241,66,847.4100000000001,4,2,2,8,Gold
13223.0,201,5,163.20000000000002,4,4,4,12,Bronze
13224.0,61,108,2155.9499999999994,3,1,1,5,Platinum
13225.0,4,32,6463.84,1,3,1,5,Platinum
13226.0,274,16,108.21,4,4,4,12,Bronze
13227.0,202,9,257.7,4,4,4,12,Bronze
13228.0,82,2,358.0,3,4,3,10,Silver
13229.0,226,10,160.95,4,4,4,12,Bronze
13230.0,5,587,2755.6299999999997,1,1,1,3,Platinum
13232.0,13,202,1328.35,1,1,2,4,Platinum
13233.0,75,43,605.1199999999999,3,2,3,8,Gold
13235.0,213,58,1031.0700000000002,4,2,2,8,Gold
13236.0,25,36,744.85,2,3,2,7,Gold
13238.0,18,31,700.7299999999999,1,3,2,6,Gold
13239.0,262,21,329.56,4,3,3,10,Silver
13240.0,97,67,663.6500000000001,3,2,3,8,Gold
13242.0,113,13,270.40000000000003,3,4,4,11,Bronze
13243.0,204,57,585.12,4,2,3,9,Silver
13244.0,93,27,121.74,3,3,4,10,Silver
13245.0,51,16,430.5,2,4,3,9,Silver
13246.0,19,136,1961.52,2,1,1,4,Platinum
13247.0,18,25,501.11999999999995,1,3,3,7,Gold
13248.0,125,26,465.67999999999995,3,3,3,9,Silver
13249.0,93,23,711.41,3,3,2,8,Gold
13253.0,157,36,1030.3999999999999,4,3,2,9,Silver
13255.0,10,13,399.51,1,4,3,8,Gold
13258.0,12,36,672.83,1,3,2,6,Gold
13259.0,62,81,283.18,3,2,4,9,Silver
13260.0,62,8,557.62,3,4,3,10,Silver
13261.0,269,9,944.1,4,4,2,10,Silver
13262.0,264,11,200.29,4,4,4,12,Bronze
13263.0,2,1667,7436.93,1,1,1,3,Platinum
13265.0,54,90,2092.6600000000003,3,2,1,6,Gold
13266.0,12,187,3834.26,1,1,1,3,Platinum
13267.0,3,211,4521.49,1,1,1,3,Platinum
13268.0,18,433,3174.75,1,1,1,3,Platinum
13269.0,2,315,5343.280000000001,1,1,1,3,Platinum
13270.0,367,1,590.0,4,4,3,11,Bronze
13271.0,38,87,211.48999999999992,2,2,4,8,Gold
13272.0,32,15,276.56000000000006,2,4,4,10,Silver
13273.0,114,16,138.98,3,4,4,11,Bronze
13276.0,64,30,590.93,3,3,3,9,Silver
13277.0,16,8,258.4,1,4,4,9,Silver
13278.0,41,46,542.73,2,2,3,7,Gold
13279.0,79,9,137.75,3,4,4,11,Bronze
13280.0,123,82,798.46,3,2,2,7,Gold
13282.0,19,37,1132.14,2,3,2,7,Gold
13283.0,60,7,93.66,3,4,4,11,Bronze
13284.0,331,13,201.19,4,4,4,12,Bronze
13285.0,24,187,2709.1200000000003,2,1,1,4,Platinum
13291.0,156,42,361.11,4,2,3,9,Silver
13292.0,39,31,578.9399999999999,2,3,3,8,Gold
13294.0,190,54,873.74,4,2,2,8,Gold
13295.0,360,10,201.2,4,4,4,12,Bronze
13296.0,138,5,87.4,3,4,4,11,Bronze
13297.0,8,59,2089.85,1,2,1,4,Platinum
13298.0,2,2,360.0,1,4,3,8,Gold
13299.0,269,5,142.5,4,4,4,12,Bronze
13300.0,170,20,371.89,4,3,3,10,Silver
13301.0,104,81,618.09,3,2,3,8,Gold
13302.0,156,1,63.75,4,4,4,12,Bronze
13304.0,352,21,300.41999999999996,4,3,4,11,Bronze
13305.0,5,81,2000.8599999999997,1,2,1,4,Platinum
13307.0,121,1,15.0,3,4,4,11,Bronze
13308.0,23,54,1385.51,2,2,2,6,Gold
13309.0,8,107,1456.79,1,1,2,4,Platinum
13310.0,29,72,1132.0300000000002,2,2,2,6,Gold
13311.0,5,26,598.57,1,3,3,7,Gold
13313.0,23,78,1555.32,2,2,2,6,Gold
13314.0,2,62,775.94,1,2,2,5,Platinum
13316.0,38,86,5732.93,2,2,1,5,Platinum
13317.0,67,124,2273.6800000000003,3,1,1,5,Platinum
13318.0,2,20,640.7600000000001,1,3,3,7,Gold
13319.0,6,476,10845.55,1,1,1,3,Platinum
13320.0,79,105,1532.1999999999998,3,1,2,6,Gold
13321.0,73,11,567.36,3,4,3,10,Silver
13322.0,18,25,199.48,1,3,4,8,Gold
13323.0,4,21,787.8499999999999,1,3,2,6,Gold
13324.0,37,75,7121.95,2,2,1,5,Platinum
13325.0,82,12,675.3,3,4,2,9,Silver
13327.0,39,108,3627.77,2,1,1,4,Platinum
13328.0,317,17,1308.48,4,4,2,10,Silver
13329.0,32,17,789.0,2,4,2,8,Gold
13330.0,93,53,1140.93,3,2,2,7,Gold
13332.0,15,21,350.9,1,3,3,7,Gold
13334.0,83,265,3502.32,3,1,1,5,Platinum
13336.0,78,51,795.1200000000001,3,2,2,7,Gold
13338.0,158,19,487.02000000000004,4,3,3,10,Silver
13339.0,201,54,860.12,4,2,2,8,Gold
13340.0,46,134,10736.48,2,1,1,4,Platinum
13341.0,261,42,775.8499999999999,4,2,2,8,Gold
13343.0,178,19,353.43,4,3,3,10,Silver
13344.0,68,116,2511.6900000000005,3,1,1,5,Platinum
13345.0,288,20,389.5,4,3,3,10,Silver
13347.0,71,8,341.36,3,4,3,10,Silver
13348.0,65,14,233.76,3,4,4,11,Bronze
13349.0,11,16,247.32,1,4,4,9,Silver
13350.0,17,40,979.12,1,3,2,6,Gold
13351.0,67,16,373.94,3,4,3,10,Silver
13352.0,61,24,397.97999999999996,3,3,3,9,Silver
13354.0,72,51,743.5300000000001,3,2,2,7,Gold
13355.0,123,32,674.7,3,3,2,8,Gold
13356.0,81,42,768.2400000000001,3,2,2,7,Gold
13357.0,258,89,609.4000000000001,4,2,3,9,Silver
13358.0,269,29,439.03000000000003,4,3,3,10,Silver
13359.0,64,23,439.55999999999995,3,3,3,9,Silver
13362.0,10,166,3090.7400000000002,1,1,1,3,Platinum
13363.0,18,60,992.5,1,2,2,5,Platinum
13364.0,72,10,134.96,3,4,4,11,Bronze
13365.0,34,128,2225.37,2,1,1,4,Platinum
13366.0,51,1,56.160000000000004,2,4,4,10,Silver
13368.0,257,29,623.4,4,3,3,10,Silver
13369.0,366,14,308.28,4,4,3,11,Bronze
13370.0,372,39,754.8700000000001,4,3,2,9,Silver
13372.0,90,23,378.63999999999993,3,3,3,9,Silver
13373.0,61,158,3312.2500000000005,3,1,1,5,Platinum
13375.0,89,37,778.65,3,3,2,8,Gold
13376.0,100,53,1019.76,3,2,2,7,Gold
13379.0,27,97,572.56,2,2,3,7,Gold
13381.0,32,172,3639.31,2,1,1,4,Platinum
13382.0,281,15,222.99,4,4,4,12,Bronze
13384.0,31,152,4151.93,2,1,1,4,Platinum
13385.0,330,35,534.5699999999999,4,3,3,10,Silver
13388.0,132,35,677.1,3,3,2,8,Gold
13389.0,12,51,797.9599999999999,1,2,2,5,Platinum
13390.0,75,13,544.08,3,4,3,10,Silver
13391.0,204,1,59.8,4,4,4,12,Bronze
13394.0,2,155,2520.0200000000004,1,1,1,3,Platinum
13395.0,186,21,307.71999999999997,4,3,3,10,Silver
13396.0,30,43,1360.99,2,2,2,6,Gold
13397.0,73,38,1544.1299999999999,3,3,2,8,Gold
13398.0,193,26,457.34000000000003,4,3,3,10,Silver
13402.0,128,39,621.2300000000002,3,3,3,9,Silver
13403.0,18,3,75.0,1,4,4,9,Silver
13404.0,2,11,252.49,1,4,4,9,Silver
13405.0,75,27,572.4509999999999,3,3,3,9,Silver
13408.0,2,478,28117.04,1,1,1,3,Platinum
13410.0,25,28,1003.0600000000002,2,3,2,7,Gold
13411.0,108,18,213.55,3,3,4,10,Silver
13414.0,134,24,1390.5,3,3,2,8,Gold
13416.0,44,19,712.5,2,3,2,7,Gold
13417.0,5,28,640.83,1,3,3,7,Gold
13418.0,12,304,6127.43,1,1,1,3,Platinum
13419.0,64,16,221.06,3,4,4,11,Bronze
13420.0,150,8,159.85,4,4,4,12,Bronze
13421.0,41,102,1833.7099999999998,2,1,1,4,Platinum
13422.0,65,127,2626.3,3,1,1,5,Platinum
13425.0,109,78,1624.2100000000003,3,2,2,7,Gold
13426.0,1,157,3641.3199999999997,1,1,1,3,Platinum
13427.0,20,29,582.6,2,3,3,8,Gold
13428.0,11,71,201.78,1,2,4,7,Gold
13429.0,11,67,1006.7999999999998,1,2,2,5,Platinum
13430.0,19,49,679.4499999999999,2,2,2,6,Gold
13431.0,68,46,1269.1,3,2,2,7,Gold
13434.0,75,10,534.24,3,4,3,10,Silver
13435.0,6,101,3809.89,1,1,1,3,Platinum
13436.0,2,12,196.88999999999996,1,4,4,9,Silver
13437.0,15,167,3408.0600000000004,1,1,1,3,Platinum
13439.0,256,54,283.71,4,2,4,10,Silver
13441.0,92,13,296.64000000000004,3,4,4,11,Bronze
13447.0,24,59,1129.1400000000003,2,2,2,6,Gold
13448.0,17,194,3534.6900000000005,1,1,1,3,Platinum
13449.0,24,19,291.88000000000005,2,3,4,9,Silver
13450.0,27,71,2043.72,2,2,1,5,Platinum
13451.0,27,433,2898.2599999999998,2,1,1,4,Platinum
13452.0,260,2,590.0,4,4,3,11,Bronze
13453.0,166,17,356.97999999999996,4,4,3,11,Bronze
13455.0,25,46,1058.3400000000001,2,2,2,6,Gold
13456.0,18,63,1766.72,1,2,1,4,Platinum
13458.0,8,382,9646.57,1,1,1,3,Platinum
13460.0,30,17,183.44,2,4,4,10,Silver
13461.0,39,27,1445.0000000000002,2,3,2,7,Gold
13462.0,253,9,151.5,4,4,4,12,Bronze
13464.0,59,41,674.6800000000001,3,3,2,8,Gold
13466.0,185,17,307.90000000000003,4,4,3,11,Bronze
13467.0,11,98,1071.91,1,2,2,5,Platinum
13468.0,2,302,5704.969999999999,1,1,1,3,Platinum
13470.0,100,10,165.0,3,4,4,11,Bronze
13471.0,2,254,2501.84,1,1,1,3,Platinum
13473.0,61,21,422.64000000000004,3,3,3,9,Silver
13474.0,237,62,226.83999999999995,4,2,4,10,Silver
13475.0,192,86,1431.7800000000002,4,2,2,8,Gold
13476.0,179,58,1238.47,4,2,2,8,Gold
13477.0,38,79,1454.5800000000002,2,2,2,6,Gold
13479.0,201,15,300.95,4,4,4,12,Bronze
13481.0,46,109,1804.5600000000002,2,1,1,4,Platinum
13482.0,233,11,184.64,4,4,4,12,Bronze
13483.0,66,10,140.34,3,4,4,11,Bronze
13484.0,242,8,313.8,4,4,3,11,Bronze
13485.0,234,23,454.24,4,3,3,10,Silver
13486.0,79,69,1122.4099999999999,3,2,2,7,Gold
13487.0,58,34,575.4000000000001,3,3,3,9,Silver
13488.0,18,422,8968.31,1,1,1,3,Platinum
13489.0,106,14,449.52,3,4,3,10,Silver
13491.0,52,86,1215.8199999999997,3,2,2,7,Gold
13492.0,137,50,1269.84,3,2,2,7,Gold
13493.0,276,8,618.63,4,4,3,11,Bronze
13494.0,312,18,316.26000000000005,4,3,3,10,Silver
13495.0,8,48,2044.87,1,2,1,4,Platinum
13496.0,11,35,653.3299999999999,1,3,3,7,Gold
13497.0,283,19,348.04999999999995,4,3,3,10,Silver
13499.0,18,42,1159.11,1,2,2,5,Platinum
13500.0,24,65,1166.77,2,2,2,6,Gold
13501.0,289,52,1340.32,4,2,2,8,Gold
13502.0,17,18,291.99999999999994,1,3,4,8,Gold
13503.0,72,17,216.85000000000002,3,4,4,11,Bronze
13504.0,65,22,295.93000000000006,3,3,4,10,Silver
13505.0,73,215,4393.63,3,1,1,5,Platinum
13506.0,317,26,458.52,4,3,3,10,Silver
13507.0,4,162,2479.16,1,1,1,3,Platinum
13508.0,244,12,110.97000000000003,4,4,4,12,Bronze
13509.0,9,44,979.72,1,2,2,5,Platinum
13510.0,2,115,1791.56,1,1,1,3,Platinum
13512.0,261,15,251.20999999999998,4,4,4,12,Bronze
13513.0,127,10,205.09999999999997,3,4,4,11,Bronze
13514.0,74,4,152.20000000000002,3,4,4,11,Bronze
13515.0,73,59,891.12,3,2,2,7,Gold
13516.0,22,44,1389.4100000000003,2,2,2,6,Gold
13517.0,60,141,2128.42,3,1,1,5,Platinum
13518.0,86,36,627.1600000000001,3,3,3,9,Silver
13519.0,79,8,122.75,3,4,4,11,Bronze
13520.0,59,93,3624.3499999999995,3,2,1,6,Gold
13521.0,2,418,1071.73,1,1,2,4,Platinum
13522.0,31,5,125.80000000000001,2,4,4,10,Silver
13523.0,34,172,3964.88,2,1,1,4,Platinum
13524.0,41,27,680.1800000000001,2,3,2,7,Gold
13525.0,15,6,628.78,1,4,3,8,Gold
13527.0,34,217,2242.36,2,1,1,4,Platinum
13529.0,79,15,307.76,3,4,3,10,Silver
13531.0,206,22,483.80000000000007,4,3,3,10,Silver
13532.0,34,66,210.30999999999995,2,2,4,8,Gold
13533.0,183,75,269.09000000000003,4,2,4,10,Silver
13534.0,3,296,5870.08,1,1,1,3,Platinum
13536.0,2,178,3444.39,1,1,1,3,Platinum
13538.0,44,25,1280.8500000000001,2,3,2,7,Gold
13539.0,86,37,631.34,3,3,3,9,Silver
13544.0,40,78,276.06,2,2,4,8,Gold
13546.0,13,97,621.09,1,2,3,6,Gold
13548.0,97,123,678.16,3,1,2,6,Gold
13549.0,26,51,918.1999999999999,2,2,2,6,Gold
13551.0,320,4,91.80000000000001,4,4,4,12,Bronze
13552.0,67,109,3740.0699999999997,3,1,1,5,Platinum
13555.0,74,135,4098.88,3,1,1,5,Platinum
13557.0,29,34,584.06,2,3,3,8,Gold
13558.0,6,169,594.52,1,1,3,5,Platinum
13560.0,8,32,171.42,1,3,4,8,Gold
13561.0,216,14,141.86,4,4,4,12,Bronze
13562.0,82,82,1799.33,3,2,1,6,Gold
13563.0,85,49,777.53,3,2,2,7,Gold
13564.0,145,81,1724.67,4,2,1,7,Gold
13565.0,20,38,240.22,2,3,4,9,Silver
13566.0,41,169,856.8400000000001,2,1,2,5,Platinum
13568.0,174,43,187.04999999999998,4,2,4,10,Silver
13569.0,18,79,338.61999999999995,1,2,3,6,Gold
13570.0,244,27,239.49000000000004,4,3,4,11,Bronze
13571.0,13,340,2088.94,1,1,1,3,Platinum
13572.0,206,33,1384.2499999999998,4,3,2,9,Silver
13573.0,51,25,290.25,2,3,4,9,Silver
13575.0,24,46,732.07,2,2,2,6,Gold
13576.0,11,126,6717.34,1,1,1,3,Platinum
13577.0,26,83,1687.6000000000001,2,2,1,5,Platinum
13579.0,15,23,467.0400000000001,1,3,3,7,Gold
13581.0,310,10,118.0,4,4,4,12,Bronze
13583.0,156,53,781.03,4,2,2,8,Gold
13584.0,307,24,142.4,4,3,4,11,Bronze
13587.0,64,8,712.4,3,4,2,9,Silver
13588.0,16,174,2478.95,1,1,1,3,Platinum
13589.0,15,21,379.65000000000003,1,3,3,7,Gold
13590.0,12,87,1981.9199999999994,1,2,1,4,Platinum
13591.0,65,58,1117.1299999999997,3,2,2,7,Gold
13592.0,36,16,247.95999999999998,2,4,4,10,Silver
13593.0,109,127,2011.8800000000006,3,1,1,5,Platinum
13594.0,53,26,396.97,3,3,3,9,Silver
13596.0,6,146,664.11,1,1,3,5,Platinum
13598.0,48,35,160.04000000000005,2,3,4,9,Silver
13599.0,2,246,5149.92,1,1,1,3,Platinum
13600.0,313,19,219.51999999999998,4,3,4,11,Bronze
13601.0,46,99,693.32,2,1,2,5,Platinum
13602.0,65,23,428.89,3,3,3,9,Silver
13603.0,27,27,164.34,2,3,4,9,Silver
13606.0,30,40,276.75,2,3,4,9,Silver
13607.0,41,97,675.5100000000001,2,2,2,6,Gold
13610.0,13,215,1082.33,1,1,2,4,Platinum
13611.0,90,72,1154.4,3,2,2,7,Gold
13614.0,25,195,1585.46,2,1,2,5,Platinum
13615.0,319,23,417.6900000000001,4,3,3,10,Silver
13617.0,41,44,544.1800000000001,2,2,3,7,Gold
13618.0,174,13,177.34,4,4,4,12,Bronze
13621.0,117,19,213.85,3,3,4,10,Silver
13623.0,31,78,727.7399999999999,2,2,2,6,Gold
13626.0,253,19,257.22999999999996,4,3,4,11,Bronze
13627.0,60,92,1638.47,3,2,2,7,Gold
13629.0,24,59,7792.360000000001,2,2,1,5,Platinum
13630.0,6,71,2031.7800000000002,1,2,1,4,Platinum
13631.0,100,11,3070.42,3,4,1,8,Gold
13632.0,25,145,2118.9300000000003,2,1,1,4,Platinum
13634.0,34,186,1547.3599999999997,2,1,2,5,Platinum
13635.0,68,62,1071.03,3,2,2,7,Gold
13636.0,37,63,949.12,2,2,2,6,Gold
13637.0,53,99,804.3,3,1,2,6,Gold
13638.0,16,8,122.64,1,4,4,9,Silver
13639.0,75,40,1033.3400000000001,3,3,2,8,Gold
13642.0,216,57,312.28000000000003,4,2,3,9,Silver
13643.0,32,28,519.44,2,3,3,8,Gold
13644.0,17,146,2624.26,1,1,1,3,Platinum
13645.0,121,5,252.1,3,4,4,11,Bronze
13647.0,10,78,1648.1200000000003,1,2,2,5,Platinum
13649.0,257,23,346.6,4,3,3,10,Silver
13650.0,17,96,1836.3400000000001,1,2,1,4,Platinum
13651.0,36,6,94.2,2,4,4,10,Silver
13652.0,46,63,1095.08,2,2,2,6,Gold
13654.0,44,166,2707.33,2,1,1,4,Platinum
13655.0,115,56,932.97,3,2,2,7,Gold
13656.0,165,49,379.65000000000003,4,2,3,9,Silver
13657.0,11,16,382.14,1,4,3,8,Gold
13658.0,10,108,2639.1700000000005,1,1,1,3,Platinum
13659.0,206,103,1563.0,4,1,2,7,Gold
13662.0,86,52,881.26,3,2,2,7,Gold
13663.0,180,13,189.46999999999997,4,4,4,12,Bronze
13666.0,61,12,84.65,3,4,4,11,Bronze
13667.0,150,83,299.04999999999995,4,2,4,10,Silver
13668.0,3,463,6309.83,1,1,1,3,Platinum
13669.0,51,9,218.55,2,4,4,10,Silver
13670.0,76,25,349.7,3,3,3,9,Silver
13672.0,302,6,186.39,4,4,4,12,Bronze
13673.0,19,60,387.44000000000005,2,2,3,7,Gold
13675.0,152,25,486.82000000000005,4,3,3,10,Silver
13678.0,152,16,232.6,4,4,4,12,Bronze
13680.0,2,194,3719.12,1,1,1,3,Platinum
13681.0,18,57,827.83,1,2,2,5,Platinum
13682.0,188,3,59.5,4,4,4,12,Bronze
13684.0,286,29,65.13000000000001,4,3,4,11,Bronze
13685.0,3,39,3119.44,1,3,1,5,Platinum
13686.0,183,8,72.0,4,4,4,12,Bronze
13689.0,64,6,910.0,3,4,2,9,Silver
13690.0,60,9,172.25,3,4,4,11,Bronze
13692.0,25,53,1488.32,2,2,2,6,Gold
13694.0,4,568,65039.619999999995,1,1,1,3,Platinum
13695.0,32,90,2504.13,2,2,1,5,Platinum
13697.0,39,12,151.3,2,4,4,10,Silver
13699.0,156,14,308.58,4,4,3,11,Bronze
13700.0,27,194,2248.63,2,1,1,4,Platinum
13703.0,319,1,99.5,4,4,4,12,Bronze
13704.0,6,134,2308.0600000000004,1,1,1,3,Platinum
13705.0,8,28,711.86,1,3,2,6,Gold
13706.0,303,20,330.79,4,3,3,10,Silver
13707.0,268,48,806.41,4,2,2,8,Gold
13708.0,272,49,285.3299999999999,4,2,4,10,Silver
13709.0,4,335,6307.650000000001,1,1,1,3,Platinum
13710.0,32,8,180.48,2,4,4,10,Silver
13711.0,219,13,252.06000000000003,4,4,4,12,Bronze
13712.0,247,10,228.83999999999997,4,4,4,12,Bronze
13715.0,282,104,1077.3899999999999,4,1,2,7,Gold
13716.0,270,21,138.28,4,3,4,11,Bronze
13717.0,33,102,1445.0100000000002,2,1,2,5,Platinum
13718.0,247,12,306.55,4,4,3,11,Bronze
13719.0,16,60,1041.68,1,2,2,5,Platinum
13720.0,117,43,799.9,3,2,2,7,Gold
13721.0,37,28,524.1400000000001,2,3,3,8,Gold
13722.0,132,85,2375.41,3,2,1,6,Gold
13723.0,218,6,199.85000000000002,4,4,4,12,Bronze
13725.0,50,104,1980.56,2,1,1,4,Platinum
13726.0,39,42,1079.6599999999999,2,2,2,6,Gold
13727.0,29,20,333.48,2,3,3,8,Gold
13728.0,37,63,1016.1400000000001,2,2,2,6,Gold
13730.0,136,43,752.6,3,2,2,7,Gold
13731.0,220,38,610.59,4,3,3,10,Silver
13732.0,29,33,491.86000000000007,2,3,3,8,Gold
13735.0,25,195,2883.5399999999995,2,1,1,4,Platinum
13736.0,6,190,729.8,1,1,2,4,Platinum
13737.0,201,30,339.6,4,3,3,10,Silver
13739.0,19,3,216.9,2,4,4,10,Silver
13740.0,241,23,350.75,4,3,3,10,Silver
13741.0,72,34,668.4300000000001,3,3,3,9,Silver
13742.0,17,313,3107.8700000000003,1,1,1,3,Platinum
13743.0,3,41,1341.6,1,3,2,6,Gold
13744.0,96,63,1080.52,3,2,2,7,Gold
13745.0,163,25,300.03999999999996,4,3,4,11,Bronze
13747.0,374,1,79.6,4,4,4,12,Bronze
13748.0,96,28,948.2499999999999,3,3,2,8,Gold
13750.0,54,24,1647.26,3,3,2,8,Gold
13751.0,289,9,296.25,4,4,4,12,Bronze
13752.0,125,75,1175.3799999999999,3,2,2,7,Gold
13753.0,288,35,741.26,4,3,2,9,Silver
13754.0,152,12,282.6,4,4,4,12,Bronze
13755.0,4,321,2108.06,1,1,1,3,Platinum
13756.0,3,142,5189.52,1,1,1,3,Platinum
13758.0,12,117,3190.55,1,1,1,3,Platinum
13759.0,34,25,659.41,2,3,3,8,Gold
13760.0,55,57,286.78999999999996,3,2,4,9,Silver
13761.0,51,70,1070.65,2,2,2,6,Gold
13762.0,219,7,306.72,4,4,3,11,Bronze
13763.0,64,15,1714.9599999999998,3,4,1,8,Gold
13764.0,71,207,1519.42,3,1,2,6,Gold
13767.0,3,368,17220.36,1,1,1,3,Platinum
13769.0,3,135,2796.51,1,1,1,3,Platinum
13771.0,65,119,2634.45,3,1,1,5,Platinum
13772.0,34,173,1122.63,2,1,2,5,Platinum
13774.0,82,22,345.0,3,3,3,9,Silver
13777.0,1,197,25977.160000000003,1,1,1,3,Platinum
13778.0,104,9,178.7,3,4,4,11,Bronze
13780.0,8,57,360.01000000000005,1,2,3,6,Gold
13781.0,251,17,127.84,4,4,4,12,Bronze
13782.0,13,113,908.8599999999999,1,1,2,4,Platinum
13784.0,10,31,2462.7899999999995,1,3,1,5,Platinum
13786.0,368,7,230.4,4,4,4,12,Bronze
13787.0,76,31,309.04,3,3,3,9,Silver
13790.0,5,45,348.79999999999995,1,2,3,6,Gold
13791.0,128,11,1516.0,3,4,2,9,Silver
13792.0,67,13,195.54999999999995,3,4,4,11,Bronze
13798.0,2,349,37153.85,1,1,1,3,Platinum
13799.0,117,39,688.8600000000001,3,3,2,8,Gold
13800.0,310,33,558.32,4,3,3,10,Silver
13801.0,67,23,324.79999999999995,3,3,3,9,Silver
13802.0,139,60,4599.42,3,2,1,6,Gold
13803.0,256,17,277.07000000000005,4,4,4,12,Bronze
13804.0,31,135,2588.39,2,1,1,4,Platinum
13805.0,53,13,924.5999999999999,3,4,2,9,Silver
13806.0,64,10,256.38,3,4,4,11,Bronze
13807.0,368,7,112.6,4,4,4,12,Bronze
13808.0,6,76,1747.6600000000003,1,2,1,4,Platinum
13809.0,306,12,155.05,4,4,4,12,Bronze
13810.0,29,35,1499.0100000000002,2,3,2,7,Gold
13811.0,184,13,814.5,4,4,2,10,Silver
13812.0,43,36,539.0,2,3,3,8,Gold
13813.0,40,69,1366.8600000000001,2,2,2,6,Gold
13814.0,93,57,1579.1200000000001,3,2,2,7,Gold
13815.0,23,176,4027.36,2,1,1,4,Platinum
13816.0,24,28,571.6700000000001,2,3,3,8,Gold
13817.0,30,24,382.97999999999996,2,3,3,8,Gold
13819.0,302,36,1140.35,4,3,2,9,Silver
13821.0,145,59,385.64,4,2,3,9,Silver
13822.0,6,96,632.0,1,2,3,6,Gold
13823.0,19,40,957.66,2,3,2,7,Gold
13824.0,33,46,1698.94,2,2,1,5,Platinum
13826.0,177,10,189.5,4,4,4,12,Bronze
13827.0,58,92,409.8,3,2,3,8,Gold
13828.0,23,15,209.49000000000004,2,4,4,10,Silver
13831.0,17,72,2198.45,1,2,1,4,Platinum
13832.0,20,3,52.199999999999996,2,4,4,10,Silver
13833.0,160,28,383.8499999999999,4,3,3,10,Silver
13835.0,26,55,834.57,2,2,2,6,Gold
13837.0,212,18,266.59000000000003,4,3,4,11,Bronze
13838.0,6,165,674.82,1,1,2,4,Platinum
13841.0,253,1,85.0,4,4,4,12,Bronze
13842.0,59,206,3385.6200000000003,3,1,1,5,Platinum
13844.0,12,20,361.62,1,3,3,7,Gold
13845.0,65,9,312.98,3,4,3,10,Silver
13846.0,25,55,865.0600000000002,2,2,2,6,Gold
13848.0,93,5,1255.0,3,4,2,9,Silver
13849.0,52,101,1537.95,3,1,2,6,Gold
13850.0,130,93,1595.4800000000002,3,2,2,7,Gold
13851.0,96,81,2651.4599999999996,3,2,1,6,Gold
13853.0,58,23,1090.1399999999999,3,3,2,8,Gold
13854.0,9,110,8109.52,1,1,1,3,Platinum
13856.0,169,14,388.5,4,4,3,11,Bronze
13858.0,58,11,216.17000000000002,3,4,4,11,Bronze
13859.0,327,28,201.16,4,3,4,11,Bronze
13860.0,2,76,1245.9,1,2,2,5,Platinum
13862.0,19,139,2209.36,2,1,1,4,Platinum
13863.0,248,20,305.78,4,3,4,11,Bronze
13865.0,59,30,501.56,3,3,3,9,Silver
13866.0,75,7,145.67,3,4,4,11,Bronze
13867.0,32,60,1005.0899999999999,2,2,2,6,Gold
13868.0,8,33,3192.54,1,3,1,5,Platinum
13869.0,124,304,3083.65,3,1,1,5,Platinum
13870.0,3,115,2770.94,1,1,1,3,Platinum
13871.0,23,336,6403.25,2,1,1,4,Platinum
13873.0,120,23,389.59999999999997,3,3,3,9,Silver
13874.0,359,18,540.45,4,3,3,10,Silver
13875.0,54,104,1786.79,3,1,1,5,Platinum
13876.0,64,7,122.69999999999999,3,4,4,11,Bronze
13877.0,87,3,117.24000000000001,3,4,4,11,Bronze
13878.0,55,35,1271.5699999999997,3,3,2,8,Gold
13880.0,22,165,3219.7700000000004,2,1,1,4,Platinum
13881.0,4,178,17159.52,1,1,1,3,Platinum
13882.0,3,65,1191.13,1,2,2,5,Platinum
13883.0,11,142,2674.48,1,1,1,3,Platinum
13884.0,8,59,787.6000000000001,1,2,2,5,Platinum
13885.0,190,28,506.8,4,3,3,10,Silver
13886.0,72,16,243.56,3,4,4,11,Bronze
13887.0,205,19,349.54999999999995,4,3,3,10,Silver
13888.0,120,39,595.67,3,3,3,9,Silver
13889.0,93,15,416.9,3,4,3,10,Silver
13890.0,2,110,1883.8100000000004,1,1,1,3,Platinum
13892.0,27,27,632.97,2,3,3,8,Gold
13893.0,298,21,821.1000000000001,4,3,2,9,Silver
13894.0,24,27,564.6200000000001,2,3,3,8,Gold
13895.0,29,118,2593.0699999999997,2,1,1,4,Platinum
13897.0,51,17,311.15999999999997,2,4,3,9,Silver
13898.0,326,12,155.93,4,4,4,12,Bronze
13899.0,17,19,388.52,1,3,3,7,Gold
13900.0,184,43,740.9499999999999,4,2,2,8,Gold
13901.0,73,149,2867.2,3,1,1,5,Platinum
13904.0,38,26,332.64000000000004,2,3,3,8,Gold
13908.0,80,122,2369.55,3,1,1,5,Platinum
13911.0,58,148,2580.91,3,1,1,5,Platinum
13914.0,12,33,626.45,1,3,3,7,Gold
13917.0,50,18,272.03999999999996,2,3,4,9,Silver
13918.0,50,30,1212.8400000000004,2,3,2,7,Gold
13919.0,60,28,384.81000000000006,3,3,3,9,Silver
13922.0,352,7,172.24999999999997,4,4,4,12,Bronze
13923.0,54,20,351.13000000000005,3,3,3,9,Silver
13924.0,2,117,1838.85,1,1,1,3,Platinum
13925.0,93,41,678.25,3,3,2,8,Gold
13926.0,24,11,223.85000000000002,2,4,4,10,Silver
13927.0,75,21,348.99000000000007,3,3,3,9,Silver
13928.0,11,27,464.57,1,3,3,7,Gold
13929.0,170,9,842.65,4,4,2,10,Silver
13930.0,58,17,337.34,3,4,3,10,Silver
13931.0,96,58,1237.53,3,2,2,7,Gold
13932.0,295,16,307.4,4,4,3,11,Bronze
13933.0,110,23,608.7899999999998,3,3,3,9,Silver
13934.0,264,31,922.0999999999999,4,3,2,9,Silver
13936.0,180,26,376.5799999999999,4,3,3,10,Silver
13937.0,170,9,158.85,4,4,4,12,Bronze
13938.0,36,7,71.66,2,4,4,10,Silver
13939.0,24,45,568.55,2,2,3,7,Gold
13940.0,18,49,839.14,1,2,2,5,Platinum
13941.0,22,45,5112.96,2,2,1,5,Platinum
13946.0,80,11,561.57,3,4,3,10,Silver
13947.0,66,5,90.6,3,4,4,11,Bronze
13948.0,361,3,101.99999999999999,4,4,4,12,Bronze
13949.0,3,160,2427.3199999999997,1,1,1,3,Platinum
13950.0,12,35,745.0600000000001,1,3,2,6,Gold
13951.0,177,39,674.4499999999998,4,3,2,9,Silver
13952.0,218,137,3251.071,4,1,1,6,Gold
13953.0,8,20,3515.6799999999994,1,3,1,5,Platinum
13954.0,2,25,439.92,1,3,3,7,Gold
13955.0,155,33,322.96,4,3,3,10,Silver
13956.0,6,147,1019.2700000000001,1,1,2,4,Platinum
13959.0,80,90,594.04,3,2,3,8,Gold
13960.0,22,12,230.22,2,4,4,10,Silver
13962.0,22,11,169.55,2,4,4,10,Silver
13963.0,309,35,664.5400000000001,4,3,3,10,Silver
13967.0,146,2,80.7,4,4,4,12,Bronze
13969.0,8,619,9024.17,1,1,1,3,Platinum
13971.0,19,149,2758.26,2,1,1,4,Platinum
13972.0,71,15,190.25000000000003,3,4,4,11,Bronze
13973.0,288,11,264.7,4,4,4,12,Bronze
13974.0,50,28,413.59,2,3,3,8,Gold
13975.0,32,329,2461.24,2,1,1,4,Platinum
13976.0,207,10,357.98,4,4,3,11,Bronze
13978.0,15,15,196.79,1,4,4,9,Silver
13979.0,74,54,869.8699999999998,3,2,2,7,Gold
13980.0,61,11,200.14000000000001,3,4,4,11,Bronze
13982.0,40,111,1871.81,2,1,1,4,Platinum
13983.0,30,107,2603.4300000000003,2,1,1,4,Platinum
13984.0,27,16,920.51,2,4,2,8,Gold
13985.0,5,349,7060.13,1,1,1,3,Platinum
13986.0,18,13,320.46000000000004,1,4,3,8,Gold
13988.0,20,234,4147.96,2,1,1,4,Platinum
13989.0,66,41,1266.08,3,3,2,8,Gold
13990.0,214,16,311.3,4,4,3,11,Bronze
13991.0,13,82,852.88,1,2,2,5,Platinum
13992.0,31,5,76.8,2,4,4,10,Silver
13993.0,43,121,3466.3600000000006,2,1,1,4,Platinum
13994.0,4,148,2274.1400000000003,1,1,1,3,Platinum
13995.0,16,86,1393.69,1,2,2,5,Platinum
13999.0,11,208,3901.81,1,1,1,3,Platinum
14000.0,212,15,635.6600000000001,4,4,3,11,Bronze
14001.0,46,39,2043.0800000000002,2,3,1,6,Gold
14002.0,135,47,529.7299999999999,3,2,3,8,Gold
14004.0,44,171,4582.639999999999,2,1,1,4,Platinum
14005.0,10,84,2874.72,1,2,1,4,Platinum
14006.0,116,30,962.1899999999999,3,3,2,8,Gold
14009.0,199,42,695.6099999999999,4,2,2,8,Gold
14012.0,278,11,328.8,4,4,3,11,Bronze
14013.0,111,34,473.02,3,3,3,9,Silver
14014.0,78,39,505.18,3,3,3,9,Silver
14015.0,53,20,917.34,3,3,2,8,Gold
14016.0,162,161,4341.21,4,1,1,6,Gold
14019.0,47,66,1421.61,2,2,2,6,Gold
14020.0,17,39,642.8000000000001,1,3,3,7,Gold
14021.0,156,22,631.9000000000001,4,3,3,10,Silver
14022.0,226,28,440.0,4,3,3,10,Silver
14023.0,8,31,584.0699999999999,1,3,3,7,Gold
14024.0,122,16,327.70000000000005,3,4,3,10,Silver
14027.0,61,6,104.82000000000002,3,4,4,11,Bronze
14029.0,64,15,467.66,3,4,3,10,Silver
14030.0,19,242,2358.8399999999997,2,1,1,4,Platinum
14031.0,8,250,17286.86,1,1,1,3,Platinum
14032.0,3,143,2975.59,1,1,1,3,Platinum
14034.0,23,86,648.8900000000001,2,2,3,7,Gold
14035.0,29,66,1428.0200000000002,2,2,2,6,Gold
14036.0,285,38,626.65,4,3,3,10,Silver
14037.0,177,28,147.2,4,3,4,11,Bronze
14038.0,79,92,1560.3799999999994,3,2,2,7,Gold
14039.0,34,6,152.2,2,4,4,10,Silver
14040.0,41,229,3560.32,2,1,1,4,Platinum
14041.0,267,21,141.41,4,3,4,11,Bronze
14044.0,27,206,646.4200000000001,2,1,3,6,Gold
14045.0,110,6,1659.75,3,4,2,9,Silver
14046.0,285,14,154.99,4,4,4,12,Bronze
14047.0,9,32,1308.6100000000001,1,3,2,6,Gold
14048.0,306,85,409.93,4,2,3,9,Silver
14049.0,17,478,5578.72,1,1,1,3,Platinum
14050.0,32,54,746.3599999999999,2,2,2,6,Gold
14051.0,1,210,15610.390000000003,1,1,1,3,Platinum
14052.0,20,56,225.36,2,2,4,8,Gold
14053.0,125,4,260.25,3,4,4,11,Bronze
14054.0,66,6,92.46,3,4,4,11,Bronze
14055.0,107,10,725.6400000000001,3,4,2,9,Silver
14056.0,2,1088,8152.710000000001,1,1,1,3,Platinum
14057.0,24,283,6211.66,2,1,1,4,Platinum
14059.0,267,8,183.6,4,4,4,12,Bronze
14060.0,5,202,6140.42,1,1,1,3,Platinum
14062.0,10,111,10464.850000000002,1,1,1,3,Platinum
14064.0,30,77,1334.3399999999997,2,2,2,6,Gold
14066.0,267,7,152.55,4,4,4,12,Bronze
14067.0,64,52,374.7,3,2,3,8,Gold
14068.0,321,24,265.85,4,3,4,11,Bronze
14071.0,4,323,1437.5700000000002,1,1,2,4,Platinum
14073.0,33,13,151.04,2,4,4,10,Silver
14075.0,5,43,942.26,1,2,2,5,Platinum
14076.0,130,44,118.67,3,2,4,9,Silver
14077.0,41,42,499.4200000000001,2,2,3,7,Gold
14078.0,102,65,1049.37,3,2,2,7,Gold
14079.0,125,12,375.0999999999999,3,4,3,10,Silver
14080.0,33,4,45.599999999999994,2,4,4,10,Silver
14081.0,303,150,921.62,4,1,2,7,Gold
14082.0,365,29,182.24999999999997,4,3,4,11,Bronze
14083.0,5,177,1002.9000000000001,1,1,2,4,Platinum
14085.0,3,448,4421.290000000001,1,1,1,3,Platinum
14087.0,3,68,191.47,1,2,4,7,Gold
14088.0,11,589,50491.81,1,1,1,3,Platinum
14089.0,57,13,158.75,3,4,4,11,Bronze
14090.0,325,1,76.32000000000001,4,4,4,12,Bronze
14092.0,8,214,4076.91,1,1,1,3,Platinum
14093.0,13,100,433.85999999999996,1,1,3,5,Platinum
14096.0,5,5111,65164.79,1,1,1,3,Platinum
14098.0,37,21,147.34999999999997,2,3,4,9,Silver
14099.0,17,250,3104.17,1,1,1,3,Platinum
14100.0,138,25,191.95000000000002,3,3,4,10,Silver
14101.0,74,35,5976.790000000001,3,3,1,7,Gold
14102.0,6,58,1105.8799999999999,1,2,2,5,Platinum
14104.0,155,21,216.20999999999998,4,3,4,11,Bronze
14105.0,240,74,1266.23,4,2,2,8,Gold
14107.0,52,123,2703.23,3,1,1,5,Platinum
14108.0,31,34,597.9100000000001,2,3,3,8,Gold
14109.0,73,9,144.2,3,4,4,11,Bronze
14110.0,4,155,5683.1500000000015,1,1,1,3,Platinum
14111.0,15,10,692.85,1,4,2,7,Gold
14112.0,23,160,2915.15,2,1,1,4,Platinum
14113.0,4,34,1840.4199999999998,1,3,1,5,Platinum
14114.0,274,15,386.53,4,4,3,11,Bronze
14116.0,20,72,1382.7399999999998,2,2,2,6,Gold
14117.0,144,3,90.0,4,4,4,12,Bronze
14121.0,4,159,2780.15,1,1,1,3,Platinum
14124.0,85,5,419.58000000000004,3,4,3,10,Silver
14125.0,11,166,2720.63,1,1,1,3,Platinum
14126.0,8,15,706.1300000000001,1,4,2,7,Gold
14127.0,123,44,709.7099999999999,3,2,2,7,Gold
14128.0,61,46,637.5000000000002,3,2,3,8,Gold
14129.0,2,52,1123.8600000000001,1,2,2,5,Platinum
14130.0,320,66,480.9100000000001,4,2,3,9,Silver
14132.0,3,200,3586.0299999999997,1,1,1,3,Platinum
14133.0,130,28,605.6399999999999,3,3,3,9,Silver
14135.0,2,134,4690.3099999999995,1,1,1,3,Platinum
14138.0,2,46,965.8800000000002,1,2,2,5,Platinum
14139.0,47,26,415.81999999999994,2,3,3,8,Gold
14140.0,4,66,935.05,1,2,2,5,Platinum
14141.0,3,40,915.1300000000001,1,3,2,6,Gold
14142.0,374,22,311.81,4,3,3,10,Silver
14143.0,134,7,115.8,3,4,4,11,Bronze
14145.0,47,11,3742.2,2,4,1,7,Gold
14146.0,9,210,4191.0,1,1,1,3,Platinum
14147.0,79,5,483.4,3,4,3,10,Silver
14148.0,234,3,157.2,4,4,4,12,Bronze
14149.0,221,28,446.62000000000006,4,3,3,10,Silver
14150.0,36,26,658.64,2,3,3,8,Gold
14152.0,76,49,621.29,3,2,3,8,Gold
14154.0,240,52,1345.62,4,2,2,8,Gold
14155.0,267,6,118.75,4,4,4,12,Bronze
14156.0,10,1395,117210.08,1,1,1,3,Platinum
14157.0,20,46,424.89000000000004,2,2,3,7,Gold
14158.0,41,41,507.65999999999997,2,3,3,8,Gold
14159.0,20,1175,4630.35,2,1,1,4,Platinum
14161.0,216,104,1097.62,4,1,2,7,Gold
14162.0,174,25,289.36,4,3,4,11,Bronze
14163.0,88,52,2445.9100000000003,3,2,1,6,Gold
14164.0,71,29,1631.7700000000004,3,3,2,8,Gold
14165.0,276,24,120.44,4,3,4,11,Bronze
14167.0,40,50,562.59,2,2,3,7,Gold
14171.0,99,58,363.79,3,2,3,8,Gold
14173.0,11,29,450.8400000000001,1,3,3,7,Gold
14174.0,34,26,134.46,2,3,4,9,Silver
14175.0,60,149,3222.3,3,1,1,5,Platinum
14176.0,298,31,576.9,4,3,3,10,Silver
14177.0,87,41,549.46,3,3,3,9,Silver
14178.0,9,318,1600.2600000000002,1,1,2,4,Platinum
14179.0,41,157,701.5699999999999,2,1,2,5,Platinum
14180.0,11,240,4748.52,1,1,1,3,Platinum
14184.0,67,24,452.89,3,3,3,9,Silver
14185.0,332,3,197.65,4,4,4,12,Bronze
14188.0,31,65,2054.36,2,2,1,5,Platinum
14189.0,3,265,4654.08,1,1,1,3,Platinum
14191.0,2,259,4684.76,1,1,1,3,Platinum
14193.0,68,42,853.3900000000001,3,2,2,7,Gold
14194.0,5,579,11349.52,1,1,1,3,Platinum
14195.0,202,7,1011.9999999999998,4,4,2,10,Silver
14196.0,107,6,335.52,3,4,3,10,Silver
14198.0,19,39,701.4,2,3,2,7,Gold
14199.0,219,2,185.39999999999998,4,4,4,12,Bronze
14201.0,61,37,747.4400000000002,3,3,2,8,Gold
14204.0,3,39,150.60999999999996,1,3,4,8,Gold
14205.0,17,24,466.70000000000005,1,3,3,7,Gold
14206.0,240,20,328.15999999999997,4,3,3,10,Silver
14208.0,95,10,151.73999999999998,3,4,4,11,Bronze
14209.0,11,87,2073.4300000000003,1,2,1,4,Platinum
14210.0,106,102,1905.8400000000001,3,1,1,5,Platinum
14211.0,54,112,2241.1000000000004,3,1,1,5,Platinum
14212.0,90,9,1070.48,3,4,2,9,Silver
14214.0,31,67,1004.3800000000001,2,2,2,6,Gold
14215.0,12,108,1789.72,1,1,1,3,Platinum
14216.0,4,59,1839.3000000000002,1,2,1,4,Platinum
14217.0,2,100,2004.9799999999998,1,1,1,3,Platinum
14218.0,43,12,169.48000000000002,2,4,4,10,Silver
14219.0,5,7,89.94,1,4,4,9,Silver
14220.0,248,21,632.3999999999999,4,3,3,10,Silver
14221.0,43,193,3432.8,2,1,1,4,Platinum
14222.0,178,41,683.1700000000001,4,3,2,9,Silver
14223.0,93,60,991.1300000000001,3,2,2,7,Gold
14224.0,111,113,1009.73,3,1,2,6,Gold
14226.0,29,66,2214.7899999999995,2,2,1,5,Platinum
14227.0,27,175,3350.96,2,1,1,4,Platinum
14229.0,52,40,1547.2,3,3,2,8,Gold
14231.0,184,50,925.71,4,2,2,8,Gold
14232.0,43,115,2048.07,2,1,1,4,Platinum
14233.0,50,35,1462.7200000000003,2,3,2,7,Gold
14234.0,23,147,754.1200000000001,2,1,2,5,Platinum
14235.0,76,79,3144.86,3,2,1,6,Gold
14236.0,81,15,490.86,3,4,3,10,Silver
14237.0,374,9,161.00000000000003,4,4,4,12,Bronze
14238.0,327,8,146.85,4,4,4,12,Bronze
14239.0,44,112,2380.8500000000004,2,1,1,4,Platinum
14240.0,31,42,890.3400000000001,2,2,2,6,Gold
14241.0,184,10,213.70000000000005,4,4,4,12,Bronze
14242.0,235,16,280.55,4,4,4,12,Bronze
14243.0,9,141,2588.7699999999995,1,1,1,3,Platinum
14245.0,220,108,1693.4499999999998,4,1,1,6,Gold
14246.0,111,75,1474.0600000000002,3,2,2,7,Gold
14247.0,279,20,136.76999999999998,4,3,4,11,Bronze
14248.0,319,8,302.58,4,4,4,12,Bronze
14250.0,8,111,1904.05,1,1,1,3,Platinum
14251.0,2,78,2879.7,1,2,1,4,Platinum
14256.0,261,53,969.06,4,2,2,8,Gold
14257.0,65,106,3099.7200000000003,3,1,1,5,Platinum
14258.0,10,111,12669.98,1,1,1,3,Platinum
14259.0,142,5,120.0,3,4,4,11,Bronze
14261.0,51,52,1163.45,2,2,2,6,Gold
14262.0,9,143,2618.2299999999996,1,1,1,3,Platinum
14264.0,155,17,333.97,4,4,3,11,Bronze
14265.0,110,31,530.18,3,3,3,9,Silver
14267.0,163,55,1516.24,4,2,2,8,Gold
14270.0,332,29,492.65,4,3,3,10,Silver
14271.0,226,10,112.32,4,4,4,12,Bronze
14272.0,74,33,437.96000000000004,3,3,3,9,Silver
14273.0,52,29,559.97,3,3,3,9,Silver
14276.0,99,64,1119.7400000000002,3,2,2,7,Gold
14277.0,16,222,4188.0,1,1,1,3,Platinum
14280.0,197,8,134.04,4,4,4,12,Bronze
14282.0,4,154,3701.4400000000005,1,1,1,3,Platinum
14284.0,31,32,595.25,2,3,3,8,Gold
14285.0,22,27,1910.0100000000002,2,3,1,6,Gold
14286.0,24,280,4628.75,2,1,1,4,Platinum
14287.0,9,9,176.63,1,4,4,9,Silver
14288.0,214,16,426.6,4,4,3,11,Bronze
14289.0,9,47,911.26,1,2,2,5,Platinum
14290.0,12,101,2314.6499999999996,1,1,1,3,Platinum
14291.0,2,237,3883.25,1,1,1,3,Platinum
14292.0,8,100,4871.929999999999,1,1,1,3,Platinum
14293.0,4,61,1046.56,1,2,2,5,Platinum
14295.0,41,5,166.2,2,4,4,10,Silver
14297.0,18,62,1305.3299999999997,1,2,2,5,Platinum
14298.0,9,1637,51527.299999999996,1,1,1,3,Platinum
14299.0,9,143,3965.62,1,1,1,3,Platinum
14300.0,19,3,43.2,2,4,4,10,Silver
14301.0,118,13,640.1400000000001,3,4,3,10,Silver
14304.0,223,17,383.45000000000005,4,4,3,11,Bronze
14305.0,72,105,1858.9600000000003,3,1,1,5,Platinum
14306.0,52,33,2093.3199999999997,3,3,1,7,Gold
14307.0,89,180,2995.72,3,1,1,5,Platinum
14309.0,9,117,2352.53,1,1,1,3,Platinum
14311.0,243,20,310.26,4,3,3,10,Silver
14312.0,47,87,1611.59,2,2,2,6,Gold
14314.0,107,8,120.0,3,4,4,11,Bronze
14315.0,45,101,2481.13,2,1,1,4,Platinum
14317.0,65,24,508.58,3,3,3,9,Silver
14320.0,207,31,477.78999999999996,4,3,3,10,Silver
14321.0,11,123,1530.7500000000002,1,1,2,4,Platinum
14323.0,115,36,605.0600000000001,3,3,3,9,Silver
14326.0,243,8,183.85000000000002,4,4,4,12,Bronze
14327.0,164,12,311.65000000000003,4,4,3,11,Bronze
14329.0,18,258,4975.24,1,1,1,3,Platinum
14331.0,125,28,462.65999999999997,3,3,3,9,Silver
14332.0,23,25,840.21,2,3,2,7,Gold
14333.0,68,15,415.2,3,4,3,10,Silver
14334.0,17,162,2552.2100000000005,1,1,1,3,Platinum
14335.0,17,60,454.85999999999996,1,2,3,6,Gold
14336.0,17,90,1614.91,1,2,2,5,Platinum
14338.0,162,31,588.2199999999999,4,3,3,10,Silver
14339.0,243,14,309.52,4,4,3,11,Bronze
14340.0,219,6,134.7,4,4,4,12,Bronze
14341.0,46,128,2166.9799999999996,2,1,1,4,Platinum
14342.0,22,21,668.5600000000002,2,3,3,8,Gold
14344.0,128,71,889.9300000000002,3,2,2,7,Gold
14345.0,39,6,108.97999999999999,2,4,4,10,Silver
14346.0,121,60,1021.58,3,2,2,7,Gold
14348.0,261,18,409.57,4,3,3,10,Silver
14349.0,11,31,133.5,1,3,4,8,Gold
14350.0,275,18,282.92999999999995,4,3,4,11,Bronze
14351.0,165,1,51.0,4,4,4,12,Bronze
14352.0,158,47,1078.9600000000003,4,2,2,8,Gold
14353.0,216,6,90.6,4,4,4,12,Bronze
14354.0,6,9,163.62,1,4,4,9,Silver
14355.0,366,11,174.4,4,4,4,12,Bronze
14356.0,80,33,701.23,3,3,2,8,Gold
14357.0,44,40,225.12,2,3,4,9,Silver
14359.0,20,55,912.1800000000001,2,2,2,6,Gold
14360.0,32,117,2118.03,2,1,1,4,Platinum
14362.0,23,37,151.50000000000003,2,3,4,9,Silver
14364.0,109,69,3717.35,3,2,1,6,Gold
14367.0,9,521,9227.82,1,1,1,3,Platinum
14368.0,320,8,155.0,4,4,4,12,Bronze
14371.0,296,4,100.5,4,4,4,12,Bronze
14373.0,359,4,76.55,4,4,4,12,Bronze
14375.0,186,66,235.56,4,2,4,10,Silver
14377.0,192,11,617.05,4,4,3,11,Bronze
14379.0,45,46,348.1,2,2,3,7,Gold
14381.0,53,56,202.68,3,2,4,9,Silver
14382.0,27,126,615.4899999999999,2,1,3,6,Gold
14383.0,39,59,1247.69,2,2,2,6,Gold
14385.0,10,14,202.10999999999999,1,4,4,9,Silver
14386.0,297,7,142.4,4,4,4,12,Bronze
14387.0,33,139,1727.6000000000001,2,1,1,4,Platinum
14388.0,11,186,3212.84,1,1,1,3,Platinum
14389.0,66,45,1043.46,3,2,2,7,Gold
14390.0,11,284,4642.57,1,1,1,3,Platinum
14393.0,219,5,67.94999999999999,4,4,4,12,Bronze
14395.0,3,348,3479.91,1,1,1,3,Platinum
14396.0,66,73,487.99000000000007,3,2,3,8,Gold
14397.0,3,87,2612.96,1,2,1,4,Platinum
14400.0,150,25,574.6999999999999,4,3,3,10,Silver
14401.0,5,182,4051.4799999999996,1,1,1,3,Platinum
14403.0,131,20,1475.8100000000002,3,3,2,8,Gold
14404.0,34,100,1449.3200000000002,2,1,2,5,Platinum
14406.0,120,8,156.75,3,4,4,11,Bronze
14407.0,108,73,2157.73,3,2,1,6,Gold
14408.0,11,106,2599.03,1,1,1,3,Platinum
14409.0,72,54,2059.4500000000003,3,2,1,6,Gold
14410.0,93,189,1100.27,3,1,2,6,Gold
14411.0,311,14,1063.0,4,4,2,10,Silver
14412.0,43,43,770.0300000000001,2,2,2,6,Gold
14413.0,363,22,121.05000000000001,4,3,4,11,Bronze
14414.0,92,97,1496.98,3,2,2,7,Gold
14415.0,2,579,5855.57,1,1,1,3,Platinum
14416.0,23,14,490.2200000000001,2,4,3,9,Silver
14418.0,4,124,1937.25,1,1,1,3,Platinum
14419.0,11,202,1051.79,1,1,2,4,Platinum
14420.0,100,29,387.52,3,3,3,9,Silver
14421.0,58,27,813.1100000000001,3,3,2,8,Gold
14422.0,1,222,4263.639999999999,1,1,1,3,Platinum
14423.0,219,3,265.2,4,4,4,12,Bronze
14424.0,18,1,322.08,1,4,3,8,Gold
14426.0,24,224,4481.67,2,1,1,4,Platinum
14427.0,51,17,363.34000000000003,2,4,3,9,Silver
14428.0,8,137,1224.0600000000002,1,1,2,4,Platinum
14431.0,303,17,470.36,4,4,3,11,Bronze
14432.0,10,377,2248.5,1,1,1,3,Platinum
14434.0,22,12,1372.8,2,4,2,8,Gold
14436.0,99,9,89.06,3,4,4,11,Bronze
14437.0,366,5,63.0,4,4,4,12,Bronze
14438.0,307,9,131.9,4,4,4,12,Bronze
14439.0,320,32,2661.24,4,3,1,8,Gold
14440.0,9,55,2357.6800000000003,1,2,1,4,Platinum
14441.0,1,51,1712.8900000000003,1,2,1,4,Platinum
14442.0,205,63,1589.82,4,2,2,8,Gold
14443.0,54,93,1420.2,3,2,2,7,Gold
14446.0,1,277,1010.35,1,1,2,4,Platinum
14447.0,19,70,1163.2300000000002,2,2,2,6,Gold
14448.0,10,20,375.35,1,3,3,7,Gold
14449.0,19,250,885.8000000000001,2,1,2,5,Platinum
14450.0,181,40,483.24999999999994,4,3,3,10,Silver
14451.0,61,105,643.9000000000001,3,1,3,7,Gold
14452.0,11,60,259.05,1,2,4,7,Gold
14453.0,191,22,119.93,4,3,4,11,Bronze
14456.0,6,947,3017.28,1,1,1,3,Platinum
14457.0,311,4,113.64,4,4,4,12,Bronze
14459.0,156,37,1837.92,4,3,1,8,Gold
14460.0,111,16,434.34000000000003,3,4,3,10,Silver
14461.0,149,180,2103.0599999999995,4,1,1,6,Gold
14462.0,67,233,1980.57,3,1,1,5,Platinum
14463.0,99,6,529.62,3,4,3,10,Silver
14465.0,247,123,1038.44,4,1,2,7,Gold
14466.0,30,72,2272.4,2,2,1,5,Platinum
14467.0,18,89,596.2600000000001,1,2,3,6,Gold
14470.0,12,43,461.19000000000005,1,2,3,6,Gold
14472.0,104,265,1852.67,3,1,1,5,Platinum
14473.0,75,7,234.34,3,4,4,11,Bronze
14474.0,47,29,547.6600000000001,2,3,3,8,Gold
14475.0,72,42,925.8499999999999,3,2,2,7,Gold
14476.0,258,17,193.0,4,4,4,12,Bronze
14477.0,20,10,1309.6000000000001,2,4,2,8,Gold
14479.0,254,18,316.24999999999994,4,3,3,10,Silver
14480.0,12,13,279.05,1,4,4,9,Silver
14481.0,165,30,636.51,4,3,3,10,Silver
14482.0,19,137,2022.81,2,1,1,4,Platinum
14483.0,282,9,137.1,4,4,4,12,Bronze
14484.0,51,14,321.92,2,4,3,9,Silver
14485.0,39,46,162.8,2,2,4,8,Gold
14487.0,27,140,1165.48,2,1,2,5,Platinum
14488.0,68,46,1064.2800000000002,3,2,2,7,Gold
14489.0,208,30,463.38,4,3,3,10,Silver
14491.0,176,17,340.93,4,4,3,11,Bronze
14493.0,8,120,2383.2400000000002,1,1,1,3,Platinum
14494.0,26,7,139.56,2,4,4,10,Silver
14495.0,51,6,123.79999999999998,2,4,4,10,Silver
14496.0,312,19,538.8100000000001,4,3,3,10,Silver
14497.0,310,29,475.37,4,3,3,10,Silver
14498.0,43,193,1957.3200000000002,2,1,1,4,Platinum
14499.0,27,190,808.44,2,1,2,5,Platinum
14500.0,89,7,356.85,3,4,3,10,Silver
14501.0,184,10,251.21,4,4,4,12,Bronze
14502.0,20,608,2429.83,2,1,1,4,Platinum
14503.0,4,164,3543.26,1,1,1,3,Platinum
14504.0,48,107,673.26,2,1,2,5,Platinum
14505.0,18,785,5859.43,1,1,1,3,Platinum
14506.0,18,295,1960.6499999999999,1,1,1,3,Platinum
14507.0,24,95,1367.8799999999997,2,2,2,6,Gold
14508.0,23,55,268.05000000000007,2,2,4,8,Gold
14511.0,12,68,1314.8100000000002,1,2,2,5,Platinum
14512.0,188,23,275.28,4,3,4,11,Bronze
14513.0,101,12,455.59000000000003,3,4,3,10,Silver
14514.0,62,69,990.2,3,2,2,7,Gold
14515.0,18,98,2076.8900000000003,1,2,1,4,Platinum
14517.0,34,18,330.45000000000005,2,3,3,8,Gold
14518.0,65,16,174.37,3,4,4,11,Bronze
14520.0,2,4,270.6,1,4,4,9,Silver
14522.0,25,17,974.54,2,4,2,8,Gold
14523.0,109,12,241.09,3,4,4,11,Bronze
14524.0,32,197,1843.83,2,1,1,4,Platinum
14525.0,20,282,4215.900000000001,2,1,1,4,Platinum
14527.0,3,971,8507.130000000001,1,1,1,3,Platinum
14528.0,38,18,364.21999999999997,2,3,3,8,Gold
14529.0,61,213,578.6099999999999,3,1,3,7,Gold
14530.0,26,213,2862.11,2,1,1,4,Platinum
14532.0,237,64,932.8500000000001,4,2,2,8,Gold
14533.0,25,62,1949.7200000000003,2,2,1,5,Platinum
14534.0,3,508,4397.3,1,1,1,3,Platinum
14535.0,61,328,2854.84,3,1,1,5,Platinum
14536.0,260,18,170.95,4,3,4,11,Bronze
14537.0,58,10,355.56000000000006,3,4,3,10,Silver
14538.0,65,19,388.24999999999994,3,3,3,9,Silver
14539.0,16,32,537.48,1,3,3,7,Gold
14540.0,10,71,952.66,1,2,2,5,Platinum
14541.0,59,105,1453.35,3,1,2,6,Gold
14542.0,186,5,103.25000000000001,4,4,4,12,Bronze
14543.0,29,71,3599.73,2,2,1,5,Platinum
14544.0,25,111,2004.3000000000004,2,1,1,4,Platinum
14546.0,6,397,2573.9300000000003,1,1,1,3,Platinum
14547.0,4,355,3974.7500000000005,1,1,1,3,Platinum
14548.0,151,4,652.8,4,4,3,11,Bronze
14549.0,312,56,289.24,4,2,4,10,Silver
14550.0,11,47,757.3700000000001,1,2,2,5,Platinum
14551.0,19,10,186.23000000000002,2,4,4,10,Silver
14552.0,152,57,164.22,4,2,4,10,Silver
14553.0,20,113,859.2700000000001,2,1,2,5,Platinum
14554.0,11,203,2279.4900000000002,1,1,1,3,Platinum
14555.0,58,19,312.54,3,3,3,9,Silver
14557.0,86,16,788.38,3,4,2,9,Silver
14560.0,8,74,2237.7699999999995,1,2,1,4,Platinum
14561.0,76,69,1080.76,3,2,2,7,Gold
14562.0,4,419,5006.77,1,1,1,3,Platinum
14565.0,96,127,3099.1200000000003,3,1,1,5,Platinum
14566.0,111,4,1432.0,3,4,2,9,Silver
14567.0,57,33,1530.3600000000001,3,3,2,8,Gold
14569.0,2,12,227.38999999999996,1,4,4,9,Silver
14570.0,281,29,218.06,4,3,4,11,Bronze
14572.0,4,262,2804.54,1,1,1,3,Platinum
14573.0,180,227,1639.8200000000002,4,1,2,7,Gold
14576.0,373,1,35.400000000000006,4,4,4,12,Bronze
14577.0,13,123,859.7100000000002,1,1,2,4,Platinum
14578.0,4,24,168.63,1,3,4,8,Gold
14581.0,17,17,138.6,1,4,4,9,Silver
14582.0,41,6,114.11,2,4,4,10,Silver
14583.0,6,302,986.9599999999999,1,1,2,4,Platinum
14584.0,170,98,1033.0600000000002,4,2,2,8,Gold
14585.0,51,29,157.05,2,3,4,9,Silver
14586.0,277,19,237.36,4,3,4,11,Bronze
14587.0,19,371,1580.29,2,1,2,5,Platinum
14589.0,372,3,39.75,4,4,4,12,Bronze
14591.0,16,176,1320.21,1,1,2,4,Platinum
14592.0,36,158,557.9399999999999,2,1,3,6,Gold
14593.0,22,151,617.15,2,1,3,6,Gold
14594.0,8,52,363.3299999999999,1,2,3,6,Gold
14595.0,20,102,1740.6000000000001,2,1,1,4,Platinum
14597.0,12,47,866.2400000000001,1,2,2,5,Platinum
14598.0,45,50,221.97,2,2,4,8,Gold
14600.0,306,25,393.33,4,3,3,10,Silver
14601.0,11,7,213.96000000000004,1,4,4,9,Silver
14603.0,275,2,660.0,4,4,3,11,Bronze
14606.0,2,2677,12076.15,1,1,1,3,Platinum
14607.0,16,81,16209.5,1,2,1,4,Platinum
14608.0,5,20,1785.1499999999999,1,3,1,5,Platinum
14609.0,73,4,601.5600000000001,3,4,3,10,Silver
14616.0,243,3,406.08000000000004,4,4,3,11,Bronze
14618.0,10,16,553.44,1,4,3,8,Gold
14619.0,246,20,394.43999999999994,4,3,3,10,Silver
14620.0,206,26,412.78000000000003,4,3,3,10,Silver
14621.0,2,92,1788.3600000000004,1,2,1,4,Platinum
14622.0,185,21,320.58,4,3,3,10,Silver
14623.0,33,133,886.7,2,1,2,5,Platinum
14624.0,58,13,225.84999999999997,3,4,4,11,Bronze
14625.0,197,53,899.63,4,2,2,8,Gold
14626.0,24,122,2791.27,2,1,1,4,Platinum
14628.0,92,24,671.9599999999999,3,3,2,8,Gold
14629.0,5,150,955.2600000000001,1,1,2,4,Platinum
14631.0,51,41,1006.98,2,3,2,7,Gold
14632.0,263,8,114.56,4,4,4,12,Bronze
14633.0,267,20,344.9000000000001,4,3,3,10,Silver
14636.0,37,28,609.8500000000001,2,3,3,8,Gold
14638.0,51,16,443.6,2,4,3,9,Silver
14639.0,53,172,2984.49,3,1,1,5,Platinum
14640.0,25,105,2107.38,2,1,1,4,Platinum
14641.0,22,7,110.46,2,4,4,10,Silver
14642.0,59,2,96.12,3,4,4,11,Bronze
14643.0,171,31,693.81,4,3,2,9,Silver
14644.0,68,26,830.76,3,3,2,8,Gold
14645.0,157,30,597.0899999999999,4,3,3,10,Silver
14646.0,2,2076,280206.02,1,1,1,3,Platinum
14647.0,202,28,236.04,4,3,4,11,Bronze
14649.0,5,186,1402.59,1,1,2,4,Platinum
14651.0,68,101,653.7499999999998,3,1,3,7,Gold
14652.0,78,29,114.18,3,3,4,10,Silver
14653.0,2,234,1926.6499999999999,1,1,1,3,Platinum
14655.0,9,49,1932.23,1,2,1,4,Platinum
14656.0,170,80,291.05,4,2,4,10,Silver
14657.0,18,126,848.22,1,1,2,4,Platinum
14658.0,6,29,247.14999999999998,1,3,4,8,Gold
14659.0,9,253,2529.93,1,1,1,3,Platinum
14660.0,87,30,285.73999999999995,3,3,4,10,Silver
14661.0,27,4,107.95,2,4,4,10,Silver
14662.0,29,157,741.3699999999999,2,1,2,5,Platinum
14664.0,20,98,636.24,2,2,3,7,Gold
14665.0,61,90,1835.6999999999998,3,2,1,6,Gold
14666.0,25,14,195.25,2,4,4,10,Silver
14667.0,11,567,9175.04,1,1,1,3,Platinum
14669.0,242,166,1259.2400000000002,4,1,2,7,Gold
14670.0,281,123,392.86,4,1,3,8,Gold
14672.0,235,61,765.55,4,2,2,8,Gold
14673.0,4,74,1736.4,1,2,1,4,Platinum
14675.0,17,97,596.36,1,2,3,6,Gold
14676.0,32,42,2548.2400000000002,2,2,1,5,Platinum
14680.0,26,258,28754.11,2,1,1,4,Platinum
14681.0,72,7,498.95,3,4,3,10,Silver
14682.0,188,2,52.0,4,4,4,12,Bronze
14684.0,26,390,1201.5099999999998,2,1,2,5,Platinum
14687.0,107,15,628.3799999999999,3,4,3,10,Silver
14688.0,8,324,5579.1,1,1,1,3,Platinum
14689.0,209,13,112.80000000000001,4,4,4,12,Bronze
14690.0,45,48,355.05000000000007,2,2,3,7,Gold
14691.0,31,71,2114.33,2,2,1,5,Platinum
14692.0,138,68,591.5500000000001,3,2,3,8,Gold
14693.0,265,8,172.9,4,4,4,12,Bronze
14696.0,5,130,2078.95,1,1,1,3,Platinum
14697.0,219,22,188.60999999999996,4,3,4,11,Bronze
14698.0,2,200,1217.27,1,1,2,4,Platinum
14699.0,215,8,109.13000000000001,4,4,4,12,Bronze
14700.0,33,112,2195.0999999999995,2,1,1,4,Platinum
14701.0,11,327,2526.09,1,1,1,3,Platinum
14702.0,2,342,3251.79,1,1,1,3,Platinum
14703.0,15,22,318.16999999999996,1,3,3,7,Gold
14704.0,12,393,1493.96,1,1,2,4,Platinum
14705.0,199,1,179.0,4,4,4,12,Bronze
14708.0,3,28,1126.37,1,3,2,6,Gold
14709.0,16,196,4921.040000000001,1,1,1,3,Platinum
14710.0,15,136,599.48,1,1,3,5,Platinum
14711.0,11,345,2839.62,1,1,1,3,Platinum
14712.0,30,25,917.07,2,3,2,7,Gold
14713.0,10,338,2662.2000000000003,1,1,1,3,Platinum
14714.0,25,10,160.19,2,4,4,10,Silver
14715.0,25,71,867.3800000000001,2,2,2,6,Gold
14716.0,44,51,307.50999999999993,2,2,3,7,Gold
14719.0,2,235,1581.8400000000001,1,1,2,4,Platinum
14720.0,6,37,663.8100000000002,1,3,3,7,Gold
14722.0,148,28,180.42,4,3,4,11,Bronze
14723.0,11,259,1122.3600000000001,1,1,2,4,Platinum
14725.0,25,47,655.5800000000002,2,2,3,7,Gold
14727.0,275,10,268.58,4,4,4,12,Bronze
14729.0,374,71,313.49000000000007,4,2,3,9,Silver
14730.0,2,462,1897.5700000000002,1,1,1,3,Platinum
14731.0,48,45,380.02000000000004,2,2,3,7,Gold
14732.0,9,147,2702.49,1,1,1,3,Platinum
14733.0,17,202,9585.91,1,1,1,3,Platinum
14735.0,4,194,6065.6900000000005,1,1,1,3,Platinum
14737.0,4,17,1164.55,1,4,2,7,Gold
14738.0,43,54,1314.45,2,2,2,6,Gold
14739.0,5,60,3902.2799999999997,1,2,1,4,Platinum
14740.0,198,89,1448.2099999999998,4,2,2,8,Gold
14741.0,12,59,1400.3400000000001,1,2,2,5,Platinum
14744.0,17,26,1099.98,1,3,2,6,Gold
14745.0,113,69,1220.2600000000002,3,2,2,7,Gold
14747.0,250,18,328.19999999999993,4,3,3,10,Silver
14748.0,30,89,1415.75,2,2,2,6,Gold
14752.0,44,5,389.63999999999993,2,4,3,9,Silver
14753.0,88,30,563.1499999999999,3,3,3,9,Silver
14754.0,45,41,638.05,2,3,3,8,Gold
14755.0,10,235,5010.280000000001,1,1,1,3,Platinum
14756.0,16,38,738.9599999999998,1,3,2,6,Gold
14757.0,76,19,420.50000000000006,3,3,3,9,Silver
14758.0,145,71,1484.06,4,2,2,8,Gold
14759.0,5,102,1625.97,1,1,2,4,Platinum
14760.0,298,5,89.2,4,4,4,12,Bronze
14761.0,59,11,255.89999999999998,3,4,4,11,Bronze
14762.0,264,21,300.52,4,3,4,11,Bronze
14764.0,47,6,278.3,2,4,4,10,Silver
14765.0,30,39,254.11,2,3,4,9,Silver
14766.0,9,135,2473.37,1,1,1,3,Platinum
14768.0,18,5,192.60000000000002,1,4,4,9,Silver
14769.0,3,1062,10416.98,1,1,1,3,Platinum
14770.0,233,52,876.42,4,2,2,8,Gold
14772.0,113,9,139.26,3,4,4,11,Bronze
14775.0,59,60,1011.8999999999999,3,2,2,7,Gold
14776.0,52,117,2538.2999999999997,3,1,1,5,Platinum
14778.0,128,35,730.8599999999999,3,3,2,8,Gold
14779.0,281,41,386.15,4,3,3,10,Silver
14780.0,55,27,447.68,3,3,3,9,Silver
14782.0,320,6,200.10000000000002,4,4,4,12,Bronze
14784.0,27,15,289.99,2,4,4,10,Silver
14785.0,11,3,77.4,1,4,4,9,Silver
14788.0,8,30,679.4399999999998,1,3,2,6,Gold
14789.0,29,6,197.64000000000001,2,4,4,10,Silver
14790.0,17,46,745.0600000000001,1,2,2,5,Platinum
14792.0,64,2,6.2,3,4,4,11,Bronze
14793.0,22,14,228.99,2,4,4,10,Silver
14794.0,3,80,1319.91,1,2,2,5,Platinum
14795.0,167,6,131.45,4,4,4,12,Bronze
14796.0,2,1132,7975.49,1,1,1,3,Platinum
14798.0,53,12,173.74,3,4,4,11,Bronze
14799.0,52,13,157.70000000000002,3,4,4,11,Bronze
14800.0,48,383,4331.790000000001,2,1,1,4,Platinum
14801.0,62,57,189.34,3,2,4,9,Silver
14803.0,163,44,845.55,4,2,2,8,Gold
14804.0,9,12,353.27,1,4,3,8,Gold
14805.0,16,46,546.4000000000001,1,2,3,6,Gold
14806.0,76,11,193.39,3,4,4,11,Bronze
14808.0,40,231,2718.6,2,1,1,4,Platinum
14810.0,41,254,2085.33,2,1,1,4,Platinum
14813.0,370,29,152.87999999999997,4,3,4,11,Bronze
14815.0,37,53,778.5,2,2,2,6,Gold
14816.0,198,4,271.85,4,4,4,12,Bronze
14817.0,201,63,1110.3400000000001,4,2,2,8,Gold
14818.0,74,48,657.8,3,2,3,8,Gold
14819.0,65,13,272.07,3,4,4,11,Bronze
14820.0,22,29,507.28999999999996,2,3,3,8,Gold
14821.0,367,2,48.800000000000004,4,4,4,12,Bronze
14823.0,181,70,321.42999999999995,4,2,3,9,Silver
14824.0,11,29,1127.7100000000003,1,3,2,6,Gold
14825.0,4,120,2221.0100000000007,1,1,1,3,Platinum
14828.0,197,17,2139.76,4,4,1,9,Silver
14829.0,30,42,697.55,2,2,2,6,Gold
14830.0,54,39,188.88,3,3,4,10,Silver
14834.0,18,67,1720.3,1,2,1,4,Platinum
14836.0,11,6,102.44999999999999,1,4,4,9,Silver
14837.0,90,108,1649.5000000000002,3,1,2,6,Gold
14840.0,268,4,62.85,4,4,4,12,Bronze
14841.0,54,138,3295.7599999999998,3,1,1,5,Platinum
14842.0,44,145,2824.6899999999996,2,1,1,4,Platinum
14844.0,64,130,3189.8100000000004,3,1,1,5,Platinum
14847.0,149,13,309.4,4,4,3,11,Bronze
14849.0,22,388,7930.54,2,1,1,4,Platinum
14850.0,312,21,325.75,4,3,3,10,Silver
14851.0,24,28,511.3499999999999,2,3,3,8,Gold
14852.0,59,143,2836.69,3,1,1,5,Platinum
14853.0,25,9,475.79999999999995,2,4,3,9,Silver
14854.0,79,126,2740.03,3,1,1,5,Platinum
14855.0,120,20,645.65,3,3,3,9,Silver
14856.0,37,65,1290.53,2,2,2,6,Gold
14857.0,60,60,1173.12,3,2,2,7,Gold
14859.0,13,58,1353.74,1,2,2,5,Platinum
14860.0,20,11,170.32,2,4,4,10,Silver
14861.0,53,6,125.79000000000002,3,4,4,11,Bronze
14862.0,26,48,841.2,2,2,2,6,Gold
14863.0,30,11,266.76,2,4,4,10,Silver
14865.0,8,4,52.2,1,4,4,9,Silver
14866.0,11,99,14389.900000000001,1,1,1,3,Platinum
14867.0,186,36,710.28,4,3,2,9,Silver
14868.0,4,144,2953.59,1,1,1,3,Platinum
14869.0,9,70,721.45,1,2,2,5,Platinum
14870.0,262,13,327.24999999999994,4,4,3,11,Bronze
14871.0,4,93,501.28,1,2,3,6,Gold
14873.0,211,28,519.6800000000001,4,3,3,10,Silver
14875.0,108,47,1465.3199999999997,3,2,2,7,Gold
14878.0,13,122,1476.0900000000001,1,1,2,4,Platinum
14880.0,78,46,690.59,3,2,2,7,Gold
14881.0,20,17,255.4,2,4,4,10,Silver
14882.0,27,11,589.7,2,4,3,9,Silver
14883.0,19,53,761.5899999999999,2,2,2,6,Gold
14885.0,132,15,765.3199999999999,3,4,2,9,Silver
14886.0,253,18,364.79999999999995,4,3,3,10,Silver
14887.0,80,6,1862.0,3,4,1,8,Gold
14888.0,208,20,369.2,4,3,3,10,Silver
14889.0,337,10,135.9,4,4,4,12,Bronze
14890.0,254,7,125.65,4,4,4,12,Bronze
14891.0,149,33,554.38,4,3,3,10,Silver
14893.0,10,73,1237.8500000000001,1,2,2,5,Platinum
14894.0,86,23,655.7499999999999,3,3,3,9,Silver
14895.0,8,498,11138.71,1,1,1,3,Platinum
14896.0,205,43,468.77000000000004,4,2,3,9,Silver
14897.0,8,55,1366.38,1,2,2,5,Platinum
14898.0,24,109,1269.31,2,1,2,5,Platinum
14901.0,12,96,1421.29,1,2,2,5,Platinum
14902.0,26,20,332.66,2,3,3,8,Gold
14903.0,22,350,2795.33,2,1,1,4,Platinum
14904.0,3,69,1025.44,1,2,2,5,Platinum
14905.0,158,17,616.15,4,4,3,11,Bronze
14907.0,4,165,3501.1000000000004,1,1,1,3,Platinum
14908.0,75,9,277.79999999999995,3,4,4,11,Bronze
14910.0,3,30,434.35,1,3,3,7,Gold
14911.0,2,5670,143711.16999999998,1,1,1,3,Platinum
14912.0,17,27,867.85,1,3,2,6,Gold
14913.0,36,87,1227.43,2,2,2,6,Gold
14915.0,92,12,307.48,3,4,3,10,Silver
14916.0,71,77,1268.98,3,2,2,7,Gold
14918.0,116,45,1610.1499999999996,3,2,2,7,Gold
14920.0,213,57,977.77,4,2,2,8,Gold
14921.0,31,78,1316.0700000000002,2,2,2,6,Gold
14923.0,51,44,749.1,2,2,2,6,Gold
14924.0,246,10,310.05,4,4,3,11,Bronze
14929.0,33,11,223.88,2,4,4,10,Silver
14930.0,109,127,2362.9600000000005,3,1,1,5,Platinum
14931.0,5,41,1257.68,1,3,2,6,Gold
14932.0,366,17,363.53,4,4,3,11,Bronze
14934.0,82,87,1890.94,3,2,1,6,Gold
14935.0,298,10,1784.71,4,4,1,9,Silver
14936.0,34,364,8137.020000000001,2,1,1,4,Platinum
14937.0,57,34,1621.88,3,3,2,8,Gold
14944.0,30,170,5900.25,2,1,1,4,Platinum
14946.0,15,3,100.9,1,4,4,9,Silver
14947.0,73,14,290.82000000000005,3,4,4,11,Bronze
14948.0,24,63,1101.97,2,2,2,6,Gold
14950.0,20,19,371.2,2,3,3,8,Gold
14951.0,80,20,311.69000000000005,3,3,3,9,Silver
14952.0,60,138,8099.489999999999,3,1,1,5,Platinum
14953.0,26,54,285.67,2,2,4,8,Gold
14954.0,13,77,294.84999999999997,1,2,4,7,Gold
14957.0,254,12,58.49,4,4,4,12,Bronze
14958.0,148,41,483.73,4,3,3,10,Silver
14959.0,65,59,695.4199999999998,3,2,2,7,Gold
14960.0,9,27,221.26999999999998,1,3,4,8,Gold
14961.0,11,312,7044.68,1,1,1,3,Platinum
14962.0,271,5,126.70000000000002,4,4,4,12,Bronze
14963.0,10,192,1472.34,1,1,2,4,Platinum
14964.0,248,13,206.21,4,4,4,12,Bronze
14965.0,97,81,596.09,3,2,3,8,Gold
14966.0,15,36,183.01999999999998,1,3,4,8,Gold
14967.0,50,6,463.8,2,4,3,9,Silver
14968.0,31,37,147.59000000000003,2,3,4,9,Silver
14970.0,69,34,1592.06,3,3,2,8,Gold
14971.0,36,155,1097.98,2,1,2,5,Platinum
14972.0,129,18,114.77,3,3,4,10,Silver
14973.0,108,32,1314.4499999999998,3,3,2,8,Gold
14974.0,38,17,89.94,2,4,4,10,Silver
14975.0,58,11,279.94,3,4,4,11,Bronze
14976.0,58,72,790.86,3,2,2,7,Gold
14978.0,73,214,1921.3700000000003,3,1,1,5,Platinum
14981.0,247,8,102.12,4,4,4,12,Bronze
14984.0,20,39,202.37,2,3,4,9,Silver
14985.0,199,83,292.01,4,2,4,10,Silver
14987.0,16,4,326.4,1,4,3,8,Gold
14988.0,212,40,334.53999999999996,4,3,3,10,Silver
14995.0,39,60,231.98000000000002,2,2,4,8,Gold
14997.0,47,26,546.2,2,3,3,8,Gold
14998.0,171,74,414.87,4,2,3,9,Silver
15000.0,48,77,490.52000000000004,2,2,3,7,Gold
15002.0,116,115,1641.7599999999998,3,1,2,6,Gold
15004.0,148,154,1220.77,4,1,2,7,Gold
15005.0,16,1112,6295.37,1,1,1,3,Platinum
15006.0,52,132,480.38000000000005,3,1,3,7,Gold
15007.0,160,12,156.91000000000003,4,4,4,12,Bronze
15009.0,13,180,1259.4299999999998,1,1,2,4,Platinum
15010.0,36,20,308.94,2,3,3,8,Gold
15012.0,54,122,405.04,3,1,3,7,Gold
15014.0,44,33,257.66999999999996,2,3,4,9,Silver
15016.0,173,20,170.04,4,3,4,11,Bronze
15017.0,34,20,125.58000000000001,2,3,4,9,Silver
15018.0,39,31,496.21,2,3,3,8,Gold
15019.0,267,66,252.81,4,2,4,10,Silver
15021.0,9,444,1871.77,1,1,1,3,Platinum
15022.0,12,121,852.39,1,1,2,4,Platinum
15023.0,4,553,6720.41,1,1,1,3,Platinum
15024.0,10,152,1636.4299999999998,1,1,2,4,Platinum
15025.0,34,67,361.96,2,2,3,7,Gold
15026.0,81,61,469.0,3,2,3,8,Gold
15027.0,31,35,1066.15,2,3,2,7,Gold
15028.0,9,48,627.1300000000001,1,2,3,6,Gold
15030.0,72,7,518.28,3,4,3,10,Silver
15031.0,5,110,653.19,1,1,3,5,Platinum
15032.0,257,52,4959.1,4,2,1,7,Gold
15033.0,5,501,2557.18,1,1,1,3,Platinum
15034.0,16,390,4274.16,1,1,1,3,Platinum
15035.0,90,27,252.73000000000002,3,3,4,10,Silver
15036.0,73,119,429.56,3,1,3,7,Gold
15038.0,59,125,685.74,3,1,2,6,Gold
15039.0,10,1477,19766.59,1,1,1,3,Platinum
15041.0,171,66,179.92999999999998,4,2,4,10,Silver
15042.0,200,5,135.93,4,4,4,12,Bronze
15043.0,32,3,537.0,2,4,3,9,Silver
15044.0,20,444,7634.7300000000005,2,1,1,4,Platinum
15045.0,152,12,735.6600000000001,4,4,2,10,Silver
15046.0,10,201,5090.42,1,1,1,3,Platinum
15047.0,270,22,343.61999999999995,4,3,3,10,Silver
15048.0,66,94,381.0,3,2,3,8,Gold
15049.0,274,3,121.17000000000002,4,4,4,12,Bronze
15050.0,26,76,1737.69,2,2,1,5,Platinum
15051.0,24,142,1383.3600000000001,2,1,2,5,Platinum
15052.0,320,28,207.73000000000002,4,3,4,11,Bronze
15053.0,5,69,693.9499999999999,1,2,2,5,Platinum
15054.0,13,114,302.1,1,1,4,6,Gold
15057.0,276,25,1489.5,4,3,2,9,Silver
15058.0,26,266,2102.54,2,1,1,4,Platinum
15059.0,41,237,1337.7199999999998,2,1,2,5,Platinum
15060.0,9,115,294.25000000000006,1,1,4,6,Gold
15061.0,4,403,54534.14,1,1,1,3,Platinum
15062.0,72,57,987.86,3,2,2,7,Gold
15063.0,214,5,370.79999999999995,4,4,3,11,Bronze
15065.0,38,155,3158.13,2,1,1,4,Platinum
15066.0,54,42,893.59,3,2,2,7,Gold
15067.0,79,82,1744.76,3,2,1,6,Gold
15068.0,47,104,553.36,2,1,3,6,Gold
15069.0,180,70,1109.5300000000002,4,2,2,8,Gold
15070.0,373,1,106.2,4,4,4,12,Bronze
15071.0,94,26,982.07,3,3,2,8,Gold
15073.0,10,54,1043.4099999999999,1,2,2,5,Platinum
15074.0,106,41,735.6700000000001,3,3,2,8,Gold
15075.0,78,27,773.03,3,3,2,8,Gold
15076.0,173,49,880.8499999999999,4,2,2,8,Gold
15078.0,8,440,9743.11,1,1,1,3,Platinum
15079.0,213,47,895.61,4,2,2,8,Gold
15081.0,23,33,504.79999999999995,2,3,3,8,Gold
15083.0,257,5,88.19999999999999,4,4,4,12,Bronze
15087.0,282,15,306.94,4,4,3,11,Bronze
15088.0,22,57,1160.0699999999997,2,2,2,6,Gold
15089.0,11,145,2420.84,1,1,1,3,Platinum
15090.0,309,23,381.32,4,3,3,10,Silver
15091.0,68,30,480.71,3,3,3,9,Silver
15092.0,216,26,457.80999999999995,4,3,3,10,Silver
15093.0,19,108,4597.0199999999995,2,1,1,4,Platinum
15095.0,104,47,1370.6,3,2,2,7,Gold
15096.0,43,11,219.39,2,4,4,10,Silver
15097.0,5,25,248.07999999999998,1,3,4,8,Gold
15098.0,183,3,39916.5,4,4,1,9,Silver
15099.0,85,23,410.48,3,3,3,9,Silver
15100.0,334,3,876.0,4,4,2,10,Silver
15101.0,9,8,317.53,1,4,3,8,Gold
15103.0,32,35,703.3599999999999,2,3,2,7,Gold
15104.0,197,67,993.5400000000001,4,2,2,8,Gold
15105.0,19,101,2298.9300000000003,2,1,1,4,Platinum
15106.0,18,100,1422.52,1,1,2,4,Platinum
15107.0,312,16,319.5,4,4,3,11,Bronze
15108.0,142,60,1300.25,3,2,2,7,Gold
15109.0,246,28,484.9500000000001,4,3,3,10,Silver
15110.0,24,35,996.1,2,3,2,7,Gold
15111.0,30,84,1567.4799999999998,2,2,2,6,Gold
15113.0,10,97,3509.4299999999994,1,2,1,4,Platinum
15114.0,31,197,2760.5599999999995,2,1,1,4,Platinum
15115.0,19,21,340.11,2,3,3,8,Gold
15116.0,18,45,1352.75,1,2,2,5,Platinum
15117.0,15,79,1551.7800000000002,1,2,2,5,Platinum
15118.0,135,1,244.8,3,4,4,11,Bronze
15119.0,246,14,266.4,4,4,4,12,Bronze
15120.0,134,21,358.8199999999999,3,3,3,9,Silver
15121.0,51,28,457.72,2,3,3,8,Gold
15122.0,115,82,1633.7799999999997,3,2,2,7,Gold
15123.0,8,106,2199.3100000000004,1,1,1,3,Platinum
15124.0,23,15,184.19000000000003,2,4,4,10,Silver
15125.0,26,127,11528.480000000001,2,1,1,4,Platinum
15127.0,66,16,406.53000000000003,3,4,3,10,Silver
15128.0,61,102,1471.0,3,1,2,6,Gold
15129.0,51,84,3447.4,2,2,1,5,Platinum
15130.0,170,22,330.11000000000007,4,3,3,10,Silver
15132.0,19,52,977.93,2,2,2,6,Gold
15133.0,128,29,982.4199999999998,3,3,2,8,Gold
15134.0,15,73,1387.99,1,2,2,5,Platinum
15135.0,240,9,139.04999999999998,4,4,4,12,Bronze
15136.0,3,68,1286.7000000000003,1,2,2,5,Platinum
15139.0,240,13,178.96,4,4,4,12,Bronze
15140.0,53,80,2354.25,3,2,1,6,Gold
15142.0,47,26,498.74000000000007,2,3,3,8,Gold
15143.0,226,14,259.45,4,4,4,12,Bronze
15144.0,9,217,6580.4400000000005,1,1,1,3,Platinum
15145.0,5,67,1194.7300000000002,1,2,2,5,Platinum
15146.0,165,91,1327.16,4,2,2,8,Gold
15147.0,241,28,623.5,4,3,3,10,Silver
15148.0,11,20,301.29,1,3,4,8,Gold
15149.0,134,23,520.8,3,3,3,9,Silver
15150.0,18,341,5291.33,1,1,1,3,Platinum
15152.0,10,271,4745.6900000000005,1,1,1,3,Platinum
15153.0,32,22,329.25,2,3,3,8,Gold
15154.0,76,71,254.27999999999997,3,2,4,9,Silver
15156.0,2,55,961.4899999999999,1,2,2,5,Platinum
15157.0,4,125,1936.0700000000004,1,1,1,3,Platinum
15158.0,46,7,401.4000000000001,2,4,3,9,Silver
15159.0,2,710,18641.010000000002,1,1,1,3,Platinum
15160.0,358,4,158.16000000000003,4,4,4,12,Bronze
15163.0,19,29,304.4699999999999,2,3,4,9,Silver
15164.0,69,101,824.58,3,1,2,6,Gold
15165.0,374,27,487.75,4,3,3,10,Silver
15167.0,321,39,158.79999999999998,4,3,4,11,Bronze
15168.0,26,5,106.56,2,4,4,10,Silver
15171.0,332,5,1289.5,4,4,2,10,Silver
15172.0,9,110,1624.05,1,1,2,4,Platinum
15174.0,323,11,135.75,4,4,4,12,Bronze
15175.0,72,23,224.14000000000004,3,3,4,10,Silver
15178.0,261,3,40.5,4,4,4,12,Bronze
15179.0,19,93,2206.9500000000003,2,2,1,5,Platinum
15180.0,368,6,87.5,4,4,4,12,Bronze
15181.0,67,16,689.48,3,4,2,9,Silver
15182.0,155,29,622.8499999999998,4,3,3,10,Silver
15184.0,30,62,402.2,2,2,3,7,Gold
15185.0,71,21,310.62,3,3,3,9,Silver
15186.0,15,19,411.41,1,3,3,7,Gold
15187.0,2,91,4777.180000000001,1,2,1,4,Platinum
15189.0,2,212,16225.390000000003,1,1,1,3,Platinum
15192.0,120,51,1044.3200000000002,3,2,2,7,Gold
15193.0,61,19,499.31999999999994,3,3,3,9,Silver
15194.0,4,310,7616.530000000001,1,1,1,3,Platinum
15195.0,3,1,3861.0,1,4,1,6,Gold
15197.0,11,32,1079.6100000000001,1,3,2,6,Gold
15198.0,93,10,193.64,3,4,4,11,Bronze
15199.0,60,13,1268.6999999999998,3,4,2,9,Silver
15201.0,88,69,1236.54,3,2,2,7,Gold
15203.0,26,142,1827.8,2,1,1,4,Platinum
15204.0,358,9,316.58,4,4,3,11,Bronze
15205.0,86,37,653.24,3,3,3,9,Silver
15206.0,11,9,420.3,1,4,3,8,Gold
15208.0,2,42,870.12,1,2,2,5,Platinum
15210.0,226,20,331.18,4,3,3,10,Silver
15211.0,61,52,894.41,3,2,2,7,Gold
15212.0,242,5,101.79999999999998,4,4,4,12,Bronze
15213.0,319,24,328.35,4,3,3,10,Silver
15214.0,2,110,1661.44,1,1,1,3,Platinum
15215.0,47,35,734.9399999999999,2,3,2,7,Gold
15216.0,88,2,96.6,3,4,4,11,Bronze
15218.0,11,166,5756.89,1,1,1,3,Platinum
15219.0,177,9,305.75,4,4,4,12,Bronze
15220.0,52,117,1778.9599999999996,3,1,1,5,Platinum
15221.0,367,5,403.25,4,4,3,11,Bronze
15222.0,319,5,585.0,4,4,3,11,Bronze
15223.0,226,20,755.75,4,3,2,9,Silver
15224.0,359,14,322.0799999999999,4,4,3,11,Bronze
15225.0,235,23,409.4000000000001,4,3,3,10,Silver
15226.0,311,8,154.41,4,4,4,12,Bronze
15227.0,37,58,1219.4,2,2,2,6,Gold
15228.0,67,125,3386.71,3,1,1,5,Platinum
15230.0,240,23,429.6,4,3,3,10,Silver
15232.0,114,31,612.0600000000001,3,3,3,9,Silver
15234.0,277,14,197.00000000000006,4,4,4,12,Bronze
15235.0,218,143,2247.51,4,1,1,6,Gold
15236.0,299,15,321.04999999999995,4,4,3,11,Bronze
15237.0,2,99,1412.3200000000002,1,1,2,4,Platinum
15238.0,30,50,1071.99,2,2,2,6,Gold
15239.0,11,49,780.59,1,2,2,5,Platinum
15240.0,45,78,1706.57,2,2,1,5,Platinum
15241.0,67,110,1756.44,3,1,1,5,Platinum
15243.0,75,22,316.68,3,3,3,9,Silver
15244.0,66,34,631.5699999999999,3,3,3,9,Silver
15245.0,135,89,2515.84,3,2,1,6,Gold
15246.0,239,33,514.15,4,3,3,10,Silver
15247.0,123,6,356.0,3,4,3,10,Silver
15249.0,32,350,6688.459999999999,2,1,1,4,Platinum
15251.0,10,111,10484.99,1,1,1,3,Platinum
15252.0,37,44,740.78,2,2,2,6,Gold
15253.0,17,53,918.1999999999998,1,2,2,5,Platinum
15254.0,128,18,300.36000000000007,3,3,4,10,Silver
15255.0,67,47,890.85,3,2,2,7,Gold
15256.0,149,6,98.45,4,4,4,12,Bronze
15257.0,284,7,317.15,4,4,3,11,Bronze
15258.0,169,34,623.1600000000001,4,3,3,10,Silver
15260.0,101,77,1810.77,3,2,1,6,Gold
15261.0,136,19,254.81999999999996,3,3,4,10,Silver
15262.0,324,10,178.95000000000002,4,4,4,12,Bronze
15263.0,107,12,156.50999999999996,3,4,4,11,Bronze
15264.0,65,23,393.7400000000001,3,3,3,9,Silver
15265.0,152,82,1506.12,4,2,2,8,Gold
15266.0,339,6,119.30000000000001,4,4,4,12,Bronze
15267.0,23,11,1717.36,2,4,1,7,Gold
15269.0,24,2,408.8,2,4,3,9,Silver
15270.0,16,41,2379.49,1,3,1,5,Platinum
15271.0,8,264,2493.34,1,1,1,3,Platinum
15272.0,58,63,721.94,3,2,2,7,Gold
15274.0,5,47,716.57,1,2,2,5,Platinum
15275.0,38,41,615.14,2,3,3,8,Gold
15276.0,67,49,128.63,3,2,4,9,Silver
15277.0,47,12,255.89999999999998,2,4,4,10,Silver
15279.0,355,19,290.51,4,3,4,11,Bronze
15280.0,173,16,113.12,4,4,4,12,Bronze
15281.0,59,139,2332.1499999999996,3,1,1,5,Platinum
15286.0,50,3,240.55,2,4,4,10,Silver
15287.0,23,20,486.69,2,3,3,8,Gold
15288.0,44,88,2306.5200000000004,2,2,1,5,Platinum
15289.0,30,58,939.78,2,2,2,6,Gold
15290.0,5,204,7943.219999999999,1,1,1,3,Platinum
15291.0,26,103,4668.300000000001,2,1,1,4,Platinum
15292.0,202,24,178.39,4,3,4,11,Bronze
15296.0,51,194,3672.8599999999997,2,1,1,4,Platinum
15297.0,11,39,641.94,1,3,3,7,Gold
15298.0,3,192,4799.9,1,1,1,3,Platinum
15299.0,68,7,4507.01,3,4,1,8,Gold
15300.0,65,28,496.43999999999994,3,3,3,9,Silver
15301.0,51,242,5049.949999999999,2,1,1,4,Platinum
15303.0,291,31,574.02,4,3,3,10,Silver
15304.0,61,23,694.4000000000002,3,3,2,8,Gold
15306.0,65,58,1174.35,3,2,2,7,Gold
15307.0,96,12,205.3,3,4,4,11,Bronze
15308.0,275,19,310.46999999999997,4,3,3,10,Silver
15311.0,1,2366,60632.75,1,1,1,3,Platinum
15312.0,76,47,924.85,3,2,2,7,Gold
15313.0,111,1,52.0,3,4,4,11,Bronze
15314.0,200,24,327.96999999999997,4,3,3,10,Silver
15315.0,65,37,570.5000000000001,3,3,3,9,Silver
15316.0,327,1,165.0,4,4,4,12,Bronze
15318.0,4,33,312.62,1,3,3,7,Gold
15319.0,284,16,204.5,4,4,4,12,Bronze
15320.0,45,36,267.13000000000005,2,3,4,9,Silver
15321.0,71,95,2748.3100000000004,3,2,1,6,Gold
15322.0,86,42,679.68,3,2,2,7,Gold
15325.0,104,48,161.74,3,2,4,9,Silver
15326.0,334,29,311.7099999999999,4,3,3,10,Silver
15327.0,53,10,208.75,3,4,4,11,Bronze
15329.0,40,57,1049.7,2,2,2,6,Gold
15330.0,33,13,714.9599999999999,2,4,2,8,Gold
15332.0,367,35,1661.06,4,3,1,8,Gold
15333.0,209,16,1028.56,4,4,2,10,Silver
15334.0,157,98,350.82,4,2,3,9,Silver
15335.0,54,35,170.22,3,3,4,10,Silver
15339.0,67,86,574.0699999999999,3,2,3,8,Gold
15341.0,81,17,2020.52,3,4,1,8,Gold
15342.0,130,24,406.09,3,3,3,9,Silver
15343.0,88,21,364.5,3,3,3,9,Silver
15344.0,1,26,563.9399999999999,1,3,3,7,Gold
15345.0,46,20,393.53999999999996,2,3,3,8,Gold
15346.0,333,17,252.42000000000002,4,4,4,12,Bronze
15347.0,367,5,201.59999999999997,4,4,4,12,Bronze
15348.0,73,9,158.04,3,4,4,11,Bronze
15349.0,159,71,463.9099999999999,4,2,3,9,Silver
15350.0,374,5,115.65,4,4,4,12,Bronze
15351.0,13,219,1934.6600000000003,1,1,1,3,Platinum
15353.0,255,61,770.1200000000001,4,2,2,8,Gold
15355.0,30,14,277.05000000000007,2,4,4,10,Silver
15356.0,32,499,2718.0300000000007,2,1,1,4,Platinum
15358.0,5,551,8347.2,1,1,1,3,Platinum
15360.0,40,13,427.92999999999995,2,4,3,9,Silver
15361.0,362,7,418.9200000000001,4,4,3,11,Bronze
15363.0,373,16,326.0,4,4,3,11,Bronze
15364.0,96,29,913.1900000000002,3,3,2,8,Gold
15365.0,26,114,2314.32,2,1,1,4,Platinum
15366.0,76,44,602.5100000000001,3,2,3,8,Gold
15367.0,58,95,1877.5900000000004,3,2,1,6,Gold
15368.0,22,4,446.94000000000005,2,4,3,9,Silver
15370.0,41,94,2386.05,2,2,1,5,Platinum
15372.0,138,27,2007.4,3,3,1,7,Gold
15373.0,9,132,2415.9100000000003,1,1,1,3,Platinum
15374.0,129,3,168.0,3,4,4,11,Bronze
15376.0,41,116,1221.5599999999997,2,1,2,5,Platinum
15379.0,170,194,3703.29,4,1,1,6,Gold
15380.0,9,36,1690.26,1,3,1,5,Platinum
15381.0,214,8,596.85,4,4,3,11,Bronze
15382.0,15,302,5955.709999999999,1,1,1,3,Platinum
15384.0,170,41,642.41,4,3,3,10,Silver
15385.0,41,12,316.88,2,4,3,9,Silver
15386.0,187,31,394.14,4,3,3,10,Silver
15388.0,271,10,140.54,4,4,4,12,Bronze
15389.0,173,1,500.0,4,4,3,11,Bronze
15392.0,5,84,1535.53,1,2,2,5,Platinum
15393.0,17,12,231.86,1,4,4,9,Silver
15394.0,10,85,2183.5400000000004,1,2,1,4,Platinum
15395.0,326,7,107.45000000000002,4,4,4,12,Bronze
15396.0,113,14,288.17999999999995,3,4,4,11,Bronze
15397.0,290,6,94.0,4,4,4,12,Bronze
15398.0,17,73,1345.5300000000002,1,2,2,5,Platinum
15399.0,2,50,815.77,1,2,2,5,Platinum
15400.0,93,12,716.2,3,4,2,9,Silver
15402.0,149,42,626.77,4,2,3,9,Silver
15405.0,190,8,349.1,4,4,3,11,Bronze
15406.0,32,53,510.71000000000004,2,2,3,7,Gold
15407.0,34,148,1046.74,2,1,2,5,Platinum
15408.0,265,34,267.18,4,3,4,11,Bronze
15410.0,85,122,3450.8400000000006,3,1,1,5,Platinum
15411.0,27,98,1348.9300000000003,2,2,2,6,Gold
15412.0,172,10,190.53,4,4,4,12,Bronze
15414.0,10,39,774.9,1,3,2,6,Gold
15415.0,314,47,559.6099999999998,4,2,3,9,Silver
15416.0,65,192,3984.3199999999997,3,1,1,5,Platinum
15417.0,86,28,508.80000000000007,3,3,3,9,Silver
15419.0,25,8,135.85999999999999,2,4,4,10,Silver
15421.0,59,53,950.36,3,2,2,7,Gold
15422.0,324,6,97.7,4,4,4,12,Bronze
15423.0,39,2,43.5,2,4,4,10,Silver
15424.0,255,17,383.34000000000003,4,4,3,11,Bronze
15426.0,20,275,1404.07,2,1,2,5,Platinum
15427.0,34,292,1430.54,2,1,2,5,Platinum
15428.0,16,6,93.78,1,4,4,9,Silver
15429.0,27,82,397.35,2,2,3,7,Gold
15432.0,24,10,171.19,2,4,4,10,Silver
15433.0,214,41,533.3,4,3,3,10,Silver
15434.0,9,55,1041.48,1,2,2,5,Platinum
15435.0,23,29,149.29000000000002,2,3,4,9,Silver
15436.0,13,291,1067.75,1,1,2,4,Platinum
15437.0,263,45,200.16,4,2,4,10,Silver
15438.0,132,25,156.57999999999998,3,3,4,10,Silver
15440.0,55,62,383.68,3,2,3,8,Gold
15442.0,249,2,594.0,4,4,3,11,Bronze
15443.0,2,372,3213.59,1,1,1,3,Platinum
15444.0,10,214,1411.2100000000003,1,1,2,4,Platinum
15445.0,265,5,113.5,4,4,4,12,Bronze
15447.0,331,9,155.17,4,4,4,12,Bronze
15448.0,313,28,494.64,4,3,3,10,Silver
15449.0,27,60,974.5200000000001,2,2,2,6,Gold
15450.0,31,30,429.84,2,3,3,8,Gold
15452.0,30,56,528.48,2,2,3,7,Gold
15453.0,2,279,1371.77,1,1,2,4,Platinum
15454.0,363,25,179.10000000000002,4,3,4,11,Bronze
15456.0,284,58,434.59000000000003,4,2,3,9,Silver
15457.0,263,58,237.07,4,2,4,10,Silver
15458.0,26,7,161.64,2,4,4,10,Silver
15460.0,355,56,214.26,4,2,4,10,Silver
15462.0,95,11,234.6,3,4,4,11,Bronze
15463.0,30,7,126.14,2,4,4,10,Silver
15464.0,339,155,1044.65,4,1,2,7,Gold
15465.0,20,97,7354.619999999999,2,2,1,5,Platinum
15466.0,86,57,334.53000000000003,3,2,3,8,Gold
15467.0,10,52,524.88,1,2,3,6,Gold
15468.0,52,24,467.51,3,3,3,9,Silver
15469.0,51,24,538.5500000000001,2,3,3,8,Gold
15471.0,3,73,454.48,1,2,3,6,Gold
15472.0,114,76,371.5600000000001,3,2,3,8,Gold
15473.0,15,11,1771.2,1,4,1,6,Gold
15475.0,78,29,454.10999999999996,3,3,3,9,Silver
15478.0,41,44,1399.9199999999998,2,2,2,6,Gold
15480.0,117,45,905.5,3,2,2,7,Gold
15482.0,16,97,10879.76,1,2,1,4,Platinum
15483.0,162,84,225.26000000000002,4,2,4,10,Silver
15484.0,2,187,3590.4100000000003,1,1,1,3,Platinum
15485.0,31,85,2564.5,2,2,1,5,Platinum
15488.0,93,2,91.32000000000001,3,4,4,11,Bronze
15489.0,23,50,1134.28,2,2,2,6,Gold
15491.0,96,154,3100.09,3,1,1,5,Platinum
15492.0,29,35,659.4599999999998,2,3,3,8,Gold
15493.0,33,289,1953.4099999999999,2,1,1,4,Platinum
15494.0,22,122,1280.58,2,1,2,5,Platinum
15497.0,18,15,1262.2,1,4,2,7,Gold
15498.0,3,512,13316.400000000001,1,1,1,3,Platinum
15500.0,9,68,1131.5600000000002,1,2,2,5,Platinum
15502.0,16,213,10384.929999999998,1,1,1,3,Platinum
15503.0,363,66,141.04,4,2,4,10,Silver
15504.0,82,13,52.83,3,4,4,11,Bronze
15505.0,53,97,3610.96,3,2,1,6,Gold
15506.0,23,161,972.0799999999999,2,1,2,5,Platinum
15507.0,172,45,475.86000000000007,4,2,3,9,Silver
15508.0,190,92,1000.2700000000001,4,2,2,8,Gold
15510.0,331,1,250.0,4,4,4,12,Bronze
15511.0,12,158,900.53,1,1,2,4,Platinum
15512.0,156,7,121.0,4,4,4,12,Bronze
15513.0,34,308,14758.22,2,1,1,4,Platinum
15514.0,13,166,4023.72,1,1,1,3,Platinum
15516.0,45,15,62.43,2,4,4,10,Silver
15517.0,234,27,267.03000000000003,4,3,4,11,Bronze
15518.0,65,210,1921.5500000000002,3,1,1,5,Platinum
15520.0,2,18,343.5,1,3,3,7,Gold
15521.0,41,185,3000.2000000000003,2,1,1,4,Platinum
15522.0,33,56,397.98999999999995,2,2,3,7,Gold
15523.0,85,10,412.01,3,4,3,10,Silver
15524.0,25,1,440.0,2,4,3,9,Silver
15525.0,3,156,734.3699999999999,1,1,2,4,Platinum
15526.0,34,4,148.44,2,4,4,10,Silver
15527.0,19,162,2428.5300000000007,2,1,1,4,Platinum
15528.0,255,26,229.32999999999998,4,3,4,11,Bronze
15529.0,23,662,3962.6,2,1,1,4,Platinum
15530.0,22,107,1497.3100000000002,2,1,2,5,Platinum
15531.0,9,219,1972.3899999999999,1,1,1,3,Platinum
15532.0,26,251,1564.73,2,1,2,5,Platinum
15533.0,20,83,807.57,2,2,2,6,Gold
15535.0,174,72,502.90000000000003,4,2,3,9,Silver
15537.0,164,24,110.92000000000002,4,3,4,11,Bronze
15539.0,8,41,538.46,1,3,3,7,Gold
15540.0,12,15,213.30000000000004,1,4,4,9,Silver
15541.0,115,29,85.13,3,3,4,10,Silver
15543.0,289,28,127.86,4,3,4,11,Bronze
15544.0,10,259,3546.7100000000005,1,1,1,3,Platinum
15545.0,55,80,288.97,3,2,4,9,Silver
15547.0,8,695,4910.6,1,1,1,3,Platinum
15549.0,78,114,1681.46,3,1,1,5,Platinum
15550.0,5,61,575.6300000000002,1,2,3,6,Gold
15551.0,37,29,436.05999999999995,2,3,3,8,Gold
15552.0,218,17,90.12,4,4,4,12,Bronze
15553.0,61,55,428.92999999999995,3,2,3,8,Gold
15554.0,278,14,217.2,4,4,4,12,Bronze
15555.0,13,887,4794.86,1,1,1,3,Platinum
15556.0,25,31,279.77,2,3,4,9,Silver
15557.0,29,19,468.90999999999997,2,3,3,8,Gold
15561.0,12,27,800.5899999999999,1,3,2,6,Gold
15562.0,352,1,134.55,4,4,4,12,Bronze
15563.0,23,113,1400.44,2,1,2,5,Platinum
15565.0,51,8,173.16000000000003,2,4,4,10,Silver
15567.0,19,7,186.01000000000002,2,4,4,10,Silver
15568.0,3,53,758.29,1,2,2,5,Platinum
15569.0,104,31,1375.71,3,3,2,8,Gold
15570.0,8,319,4148.82,1,1,1,3,Platinum
15571.0,12,57,650.4300000000001,1,2,3,6,Gold
15572.0,5,212,2533.42,1,1,1,3,Platinum
15573.0,32,97,591.1899999999999,2,2,3,7,Gold
15574.0,178,152,675.64,4,1,2,7,Gold
15576.0,38,43,921.37,2,2,2,6,Gold
15577.0,152,39,258.88000000000005,4,3,4,11,Bronze
15578.0,163,13,127.1,4,4,4,12,Bronze
15579.0,69,48,327.59999999999997,3,2,3,8,Gold
15581.0,121,146,3675.77,3,1,1,5,Platinum
15582.0,25,44,682.9100000000001,2,2,2,6,Gold
15584.0,24,122,720.8600000000001,2,1,2,5,Platinum
15585.0,177,31,455.29999999999995,4,3,3,10,Silver
15587.0,51,9,913.6800000000001,2,4,2,8,Gold
15589.0,256,29,478.53,4,3,3,10,Silver
15592.0,47,24,388.58,2,3,3,8,Gold
15593.0,71,5,199.8,3,4,4,11,Bronze
15594.0,16,103,1771.7800000000002,1,1,1,3,Platinum
15596.0,101,77,1406.5900000000001,3,2,2,7,Gold
15597.0,36,22,324.57,2,3,3,8,Gold
15598.0,54,14,240.68,3,4,4,11,Bronze
15599.0,27,52,761.74,2,2,2,6,Gold
15601.0,12,410,6776.56,1,1,1,3,Platinum
15602.0,9,46,1297.8700000000001,1,2,2,5,Platinum
15603.0,79,2,48.480000000000004,3,4,4,11,Bronze
15604.0,53,17,216.39,3,4,4,11,Bronze
15605.0,37,67,1198.23,2,2,2,6,Gold
15606.0,62,77,2920.16,3,2,1,6,Gold
15607.0,337,13,104.76,4,4,4,12,Bronze
15608.0,29,60,1093.68,2,2,2,6,Gold
15609.0,185,16,298.48,4,4,4,12,Bronze
15610.0,52,6,112.46,3,4,4,11,Bronze
15611.0,10,43,1591.4500000000003,1,2,2,5,Platinum
15612.0,37,6,195.15,2,4,4,10,Silver
15615.0,11,423,10399.74,1,1,1,3,Platinum
15618.0,33,45,776.8510000000002,2,2,2,6,Gold
15619.0,11,3,336.40000000000003,1,4,3,8,Gold
15620.0,57,100,1553.1799999999998,3,1,2,6,Gold
15621.0,5,16,1293.03,1,4,2,7,Gold
15622.0,44,185,3709.5600000000004,2,1,1,4,Platinum
15623.0,142,19,301.03,3,3,4,10,Silver
15624.0,117,34,588.13,3,3,3,9,Silver
15625.0,104,64,1534.26,3,2,2,7,Gold
15626.0,75,49,675.8000000000001,3,2,2,7,Gold
15628.0,5,155,2870.24,1,1,1,3,Platinum
15630.0,46,60,1186.35,2,2,2,6,Gold
15632.0,16,167,3285.3100000000004,1,1,1,3,Platinum
15634.0,18,15,243.55,1,4,4,9,Silver
15636.0,90,25,724.76,3,3,2,8,Gold
15637.0,53,15,223.36,3,4,4,11,Bronze
15639.0,135,25,425.32,3,3,3,9,Silver
15640.0,5,476,12416.109999999999,1,1,1,3,Platinum
15641.0,106,119,1887.2,3,1,1,5,Platinum
15643.0,192,33,664.0,4,3,3,10,Silver
15644.0,167,232,803.54,4,1,2,7,Gold
15645.0,19,52,612.01,2,2,3,7,Gold
15646.0,158,35,447.64,4,3,3,10,Silver
15648.0,205,24,639.5,4,3,3,10,Silver
15649.0,337,2,816.0,4,4,2,10,Silver
15651.0,37,32,646.3,2,3,3,8,Gold
15652.0,92,21,337.74,3,3,3,9,Silver
15653.0,93,6,877.4399999999999,3,4,2,9,Silver
15654.0,10,21,922.5300000000001,1,3,2,6,Gold
15655.0,244,34,560.6700000000001,4,3,3,10,Silver
15656.0,46,47,748.5,2,2,2,6,Gold
15657.0,23,1,30.0,2,4,4,10,Silver
15658.0,191,48,1024.1,4,2,2,8,Gold
15659.0,44,11,306.45000000000005,2,4,4,10,Silver
15660.0,26,90,1600.86,2,2,2,6,Gold
15661.0,318,5,309.8,4,4,3,11,Bronze
15663.0,107,9,138.14,3,4,4,11,Bronze
15664.0,51,17,386.43,2,4,3,9,Silver
15665.0,169,115,2222.2099999999996,4,1,1,6,Gold
15667.0,40,13,301.32000000000005,2,4,4,10,Silver
15668.0,218,1,76.32000000000001,4,4,4,12,Bronze
15669.0,41,33,684.34,2,3,2,7,Gold
15670.0,297,12,173.05,4,4,4,12,Bronze
15671.0,19,78,2657.13,2,2,1,5,Platinum
15673.0,89,138,2726.2300000000005,3,1,1,5,Platinum
15674.0,74,114,2446.6000000000004,3,1,1,5,Platinum
15675.0,82,21,323.69,3,3,3,9,Silver
15676.0,19,202,3435.7599999999998,2,1,1,4,Platinum
15677.0,50,33,657.23,2,3,3,8,Gold
15678.0,53,12,352.70000000000005,3,4,3,10,Silver
15679.0,25,110,781.2800000000001,2,1,2,5,Platinum
15680.0,10,78,1333.6799999999998,1,2,2,5,Platinum
15681.0,26,53,1426.16,2,2,2,6,Gold
15683.0,118,10,193.75,3,4,4,11,Bronze
15687.0,9,166,2993.1,1,1,1,3,Platinum
15689.0,120,9,254.1,3,4,4,11,Bronze
15690.0,5,19,239.76,1,3,4,8,Gold
15691.0,253,2,136.8,4,4,4,12,Bronze
15692.0,29,12,191.03999999999996,2,4,4,10,Silver
15694.0,1,78,6479.4,1,2,1,4,Platinum
15695.0,267,22,409.98,4,3,3,10,Silver
15696.0,34,168,2711.1099999999997,2,1,1,4,Platinum
15699.0,18,18,309.6499999999999,1,3,3,7,Gold
15700.0,173,86,696.6799999999998,4,2,2,8,Gold
15701.0,3,230,1529.0,1,1,2,4,Platinum
15703.0,265,5,211.5,4,4,4,12,Bronze
15704.0,141,117,2293.62,3,1,1,5,Platinum
15705.0,202,6,143.10000000000002,4,4,4,12,Bronze
15706.0,64,55,1060.56,3,2,2,7,Gold
15707.0,36,205,916.9799999999998,2,1,2,5,Platinum
15708.0,41,273,3235.25,2,1,1,4,Platinum
15709.0,284,6,133.25,4,4,4,12,Bronze
15712.0,10,53,1072.36,1,2,2,5,Platinum
15713.0,144,19,356.7,4,3,3,10,Silver
15714.0,12,34,330.03,1,3,3,7,Gold
15716.0,146,117,1101.1100000000001,4,1,2,7,Gold
15717.0,235,7,150.3,4,4,4,12,Bronze
15719.0,33,931,5030.07,2,1,1,4,Platinum
15720.0,25,128,598.73,2,1,3,6,Gold
15721.0,12,84,471.4000000000001,1,2,3,6,Gold
15722.0,36,67,2211.2100000000005,2,2,1,5,Platinum
15723.0,365,38,190.70000000000002,4,3,4,11,Bronze
15724.0,202,11,218.25,4,4,4,12,Bronze
15725.0,16,32,415.25,1,3,3,7,Gold
15727.0,17,301,5159.0599999999995,1,1,1,3,Platinum
15729.0,213,5,85.0,4,4,4,12,Bronze
15730.0,66,70,1120.88,3,2,2,7,Gold
15732.0,213,14,294.11999999999995,4,4,4,12,Bronze
15733.0,283,10,162.3,4,4,4,12,Bronze
15734.0,115,26,1339.45,3,3,2,8,Gold
15737.0,15,71,1188.12,1,2,2,5,Platinum
15738.0,19,173,4812.42,2,1,1,4,Platinum
15739.0,67,8,449.12,3,4,3,10,Silver
15740.0,50,9,154.88000000000002,2,4,4,10,Silver
15743.0,17,86,775.9599999999999,1,2,2,5,Platinum
15744.0,78,3,34.8,3,4,4,11,Bronze
15745.0,20,62,1094.59,2,2,2,6,Gold
15746.0,135,28,196.88000000000002,3,3,4,10,Silver
15747.0,13,90,946.6399999999999,1,2,2,5,Platinum
15748.0,41,20,144.35999999999999,2,3,4,9,Silver
15749.0,236,10,44534.3,4,4,1,9,Silver
15750.0,3,291,2463.05,1,1,1,3,Platinum
15752.0,40,405,2626.6000000000004,2,1,1,4,Platinum
15753.0,305,1,79.2,4,4,4,12,Bronze
15754.0,52,28,458.57,3,3,3,9,Silver
15755.0,11,141,2364.25,1,1,1,3,Platinum
15756.0,62,191,528.01,3,1,3,7,Gold
15757.0,66,45,714.4200000000001,3,2,2,7,Gold
15758.0,25,9,205.25,2,4,4,10,Silver
15759.0,219,7,253.04000000000002,4,4,4,12,Bronze
15762.0,66,37,583.75,3,3,3,9,Silver
15763.0,32,61,1086.9200000000003,2,2,2,6,Gold
15764.0,89,180,3279.97,3,1,1,5,Platinum
15766.0,65,11,315.05999999999995,3,4,3,10,Silver
15768.0,116,27,621.83,3,3,3,9,Silver
15769.0,8,130,56252.72,1,1,1,3,Platinum
15773.0,6,10,635.6800000000001,1,4,3,8,Gold
15774.0,69,25,270.79999999999995,3,3,4,10,Silver
15775.0,246,7,104.9,4,4,4,12,Bronze
15776.0,134,18,241.61999999999998,3,3,4,10,Silver
15777.0,242,21,1047.1100000000001,4,3,2,9,Silver
15780.0,184,29,475.28,4,3,3,10,Silver
15781.0,26,20,345.46000000000004,2,3,3,8,Gold
15782.0,10,43,2614.7400000000002,1,2,1,4,Platinum
15783.0,11,14,246.3,1,4,4,9,Silver
15785.0,33,83,2328.9700000000003,2,2,1,5,Platinum
15786.0,47,266,4919.0,2,1,1,4,Platinum
15787.0,27,200,933.26,2,1,2,5,Platinum
15789.0,359,25,351.3,4,3,3,10,Silver
15790.0,11,34,218.75000000000003,1,3,4,8,Gold
15791.0,44,75,1612.69,2,2,2,6,Gold
15793.0,15,12,965.6099999999999,1,4,2,7,Gold
15795.0,150,42,610.01,4,2,3,9,Silver
15796.0,2,132,2708.61,1,1,1,3,Platinum
15797.0,114,8,2207.4,3,4,1,8,Gold
15799.0,76,98,884.14,3,2,2,7,Gold
15800.0,108,117,696.89,3,1,2,6,Gold
15801.0,47,64,1063.95,2,2,2,6,Gold
15802.0,143,1,451.42,4,4,3,11,Bronze
15803.0,52,8,415.82000000000005,3,4,3,10,Silver
15804.0,1,262,4206.389999999999,1,1,1,3,Platinum
15805.0,24,299,5488.18,2,1,1,4,Platinum
15806.0,47,31,784.5799999999999,2,3,2,7,Gold
15807.0,51,48,903.9000000000001,2,2,2,6,Gold
15808.0,307,195,3651.27,4,1,1,6,Gold
15809.0,37,35,515.77,2,3,3,8,Gold
15810.0,79,89,1391.98,3,2,2,7,Gold
15811.0,23,133,2218.62,2,1,1,4,Platinum
15812.0,108,41,1801.14,3,3,1,7,Gold
15813.0,208,40,1303.9099999999999,4,3,2,9,Silver
15814.0,17,72,1945.33,1,2,1,4,Platinum
15815.0,64,49,2100.6,3,2,1,6,Gold
15819.0,50,123,1905.4500000000003,2,1,1,4,Platinum
15820.0,320,17,206.98,4,4,4,12,Bronze
15821.0,45,62,570.9599999999999,2,2,3,7,Gold
15822.0,4,33,885.4699999999999,1,3,2,6,Gold
15823.0,373,1,15.0,4,4,4,12,Bronze
15825.0,173,20,532.94,4,3,3,10,Silver
15826.0,57,68,1654.3100000000002,3,2,2,7,Gold
15827.0,74,115,1836.09,3,1,1,5,Platinum
15829.0,100,51,636.1399999999998,3,2,3,8,Gold
15830.0,38,39,576.0,2,3,3,8,Gold
15831.0,59,66,794.64,3,2,2,7,Gold
15832.0,255,54,836.7900000000001,4,2,2,8,Gold
15834.0,71,269,2225.15,3,1,1,5,Platinum
15835.0,45,50,954.09,2,2,2,6,Gold
15836.0,51,10,137.37,2,4,4,10,Silver
15837.0,65,24,391.98,3,3,3,9,Silver
15838.0,12,167,33643.079999999994,1,1,1,3,Platinum
15839.0,34,62,1048.49,2,2,2,6,Gold
15840.0,59,27,355.55999999999995,3,3,3,9,Silver
15841.0,73,47,1224.06,3,2,2,7,Gold
15843.0,304,8,118.95000000000002,4,4,4,12,Bronze
15844.0,47,11,130.73999999999998,2,4,4,10,Silver
15845.0,18,138,3711.77,1,1,1,3,Platinum
15847.0,39,22,389.2699999999999,2,3,3,8,Gold
15850.0,20,93,234.88,2,2,4,8,Gold
15852.0,187,22,160.70999999999998,4,3,4,11,Bronze
15853.0,52,30,110.80000000000001,3,3,4,10,Silver
15854.0,5,138,2969.12,1,1,1,3,Platinum
15855.0,137,80,712.24,3,2,2,7,Gold
15856.0,5,628,16143.64,1,1,1,3,Platinum
15857.0,19,14,296.99999999999994,2,4,4,10,Silver
15858.0,16,188,1427.5700000000002,1,1,2,4,Platinum
15860.0,41,139,965.1599999999999,2,1,2,5,Platinum
15861.0,13,540,3146.92,1,1,1,3,Platinum
15862.0,9,147,832.88,1,1,2,4,Platinum
15863.0,26,18,68.84,2,3,4,9,Silver
15864.0,23,20,1936.3200000000004,2,3,1,6,Gold
15865.0,41,40,895.13,2,3,2,7,Gold
15866.0,102,43,211.89,3,2,4,9,Silver
15867.0,6,459,3810.1400000000003,1,1,1,3,Platinum
15869.0,278,15,149.64000000000001,4,4,4,12,Bronze
15870.0,33,74,351.44000000000005,2,2,3,7,Gold
15872.0,15,108,316.25000000000006,1,1,3,5,Platinum
15874.0,64,120,4405.88,3,1,1,5,Platinum
15877.0,2,126,490.33,1,1,3,5,Platinum
15880.0,370,96,329.03,4,2,3,9,Silver
15881.0,313,29,501.39000000000004,4,3,3,10,Silver
15882.0,199,23,516.36,4,3,3,10,Silver
15883.0,3,49,396.47999999999996,1,2,3,6,Gold
15885.0,93,18,379.35,3,3,3,9,Silver
15886.0,61,12,181.09000000000003,3,4,4,11,Bronze
15888.0,81,12,168.31,3,4,4,11,Bronze
15889.0,157,85,420.07,4,2,3,9,Silver
15891.0,227,60,511.67999999999995,4,2,3,9,Silver
15894.0,254,37,258.25,4,3,4,11,Bronze
15895.0,150,11,179.17000000000002,4,4,4,12,Bronze
15897.0,195,22,208.59000000000003,4,3,4,11,Bronze
15898.0,2,84,1383.8299999999997,1,2,2,5,Platinum
15899.0,369,4,56.25,4,4,4,12,Bronze
15900.0,24,47,337.28000000000003,2,2,3,7,Gold
15901.0,17,111,351.73,1,1,3,5,Platinum
15903.0,10,74,5126.76,1,2,1,4,Platinum
15904.0,9,30,164.67999999999998,1,3,4,8,Gold
15906.0,20,150,1567.6899999999998,2,1,2,5,Platinum
15907.0,4,226,882.72,1,1,2,4,Platinum
15909.0,174,7,191.93999999999997,4,4,4,12,Bronze
15910.0,1,266,1228.88,1,1,2,4,Platinum
15912.0,179,19,264.61999999999995,4,3,4,11,Bronze
15916.0,17,151,1502.8600000000001,1,1,2,4,Platinum
15917.0,248,12,123.10000000000001,4,4,4,12,Bronze
15918.0,191,40,334.23,4,3,3,10,Silver
15919.0,20,122,525.6899999999999,2,1,3,6,Gold
15920.0,155,60,167.5,4,2,4,10,Silver
15921.0,173,24,323.03,4,3,3,10,Silver
15922.0,374,11,369.50000000000006,4,4,3,11,Bronze
15923.0,373,21,127.08000000000001,4,3,4,11,Bronze
15925.0,195,12,207.14999999999998,4,4,4,12,Bronze
15930.0,68,21,426.63000000000005,3,3,3,9,Silver
15932.0,5,115,2495.8700000000003,1,1,1,3,Platinum
15933.0,22,74,1107.4600000000003,2,2,2,6,Gold
15935.0,240,12,416.86,4,4,3,11,Bronze
15937.0,65,7,145.35,3,4,4,11,Bronze
15938.0,113,18,404.58,3,3,3,9,Silver
15939.0,90,76,6115.009999999999,3,2,1,6,Gold
15940.0,312,1,35.8,4,4,4,12,Bronze
15942.0,134,14,337.43999999999994,3,4,3,10,Silver
15944.0,277,6,325.1,4,4,3,11,Bronze
15945.0,366,2,181.0,4,4,4,12,Bronze
15947.0,83,29,1708.24,3,3,1,7,Gold
15948.0,9,60,955.2400000000001,1,2,2,5,Platinum
15949.0,17,19,364.72,1,3,3,7,Gold
15950.0,32,97,1744.71,2,2,1,5,Platinum
15951.0,9,41,708.22,1,3,2,6,Gold
15952.0,34,84,781.9100000000001,2,2,2,6,Gold
15953.0,16,97,1657.28,1,2,2,5,Platinum
15955.0,25,183,4416.26,2,1,1,4,Platinum
15957.0,32,42,428.89000000000004,2,2,3,7,Gold
15958.0,75,7,104.35,3,4,4,11,Bronze
15963.0,20,28,470.76000000000005,2,3,3,8,Gold
15965.0,18,111,808.87,1,1,2,4,Platinum
15967.0,24,80,397.67999999999995,2,2,3,7,Gold
15969.0,3,20,666.0999999999999,1,3,3,7,Gold
15970.0,304,11,314.1,4,4,3,11,Bronze
15971.0,18,35,4199.85,1,3,1,5,Platinum
15973.0,367,4,307.82,4,4,3,11,Bronze
15974.0,40,176,3442.15,2,1,1,4,Platinum
15975.0,85,24,371.01,3,3,3,9,Silver
15976.0,166,96,427.64000000000004,4,2,3,9,Silver
15977.0,18,65,1054.73,1,2,2,5,Platinum
15978.0,78,49,1098.78,3,2,2,7,Gold
15980.0,89,43,2398.8599999999997,3,2,1,6,Gold
15981.0,25,97,3408.48,2,2,1,5,Platinum
15983.0,23,112,1465.12,2,1,2,5,Platinum
15984.0,3,258,2780.63,1,1,1,3,Platinum
15985.0,124,37,1142.4199999999998,3,3,2,8,Gold
15986.0,31,14,168.11999999999998,2,4,4,10,Silver
15987.0,13,128,1432.77,1,1,2,4,Platinum
15988.0,20,26,156.78,2,3,4,9,Silver
15990.0,45,52,792.1100000000001,2,2,2,6,Gold
15992.0,4,3,41.989999999999995,1,4,4,9,Silver
15993.0,9,543,2777.67,1,1,1,3,Platinum
15994.0,55,32,414.27000000000004,3,3,3,9,Silver
15996.0,89,127,1032.58,3,1,2,6,Gold
15998.0,37,504,3080.2200000000003,2,1,1,4,Platinum
16000.0,3,9,12393.699999999999,1,4,1,6,Gold
16003.0,30,103,2735.37,2,1,1,4,Platinum
16005.0,13,201,578.71,1,1,3,5,Platinum
16006.0,212,8,101.4,4,4,4,12,Bronze
16007.0,48,381,1693.81,2,1,1,4,Platinum
16008.0,24,33,478.78000000000003,2,3,3,8,Gold
16009.0,23,82,972.1100000000001,2,2,2,6,Gold
16010.0,246,79,392.4,4,2,3,9,Silver
16011.0,9,210,3352.96,1,1,1,3,Platinum
16012.0,36,94,1415.29,2,2,2,6,Gold
16013.0,4,139,37130.600000000006,1,1,1,3,Platinum
16014.0,38,138,646.8299999999999,2,1,3,6,Gold
16015.0,4,181,704.55,1,1,2,4,Platinum
16016.0,4,224,1465.51,1,1,2,4,Platinum
16017.0,48,32,211.88,2,3,4,9,Silver
16018.0,40,28,408.90000000000003,2,3,3,8,Gold
16019.0,47,160,3786.24,2,1,1,4,Platinum
16020.0,17,46,851.01,1,2,2,5,Platinum
16022.0,261,71,602.6300000000001,4,2,3,9,Silver
16023.0,47,101,719.81,2,1,2,5,Platinum
16024.0,13,63,251.03,1,2,4,7,Gold
16025.0,30,28,439.65999999999997,2,3,3,8,Gold
16026.0,44,32,236.09,2,3,4,9,Silver
16027.0,92,16,934.6199999999999,3,4,2,9,Silver
16029.0,39,241,80850.84,2,1,1,4,Platinum
16030.0,310,29,331.24,4,3,3,10,Silver
16031.0,93,98,547.9000000000001,3,2,3,8,Gold
16033.0,6,1128,8778.82,1,1,1,3,Platinum
16034.0,197,22,437.69999999999993,4,3,3,10,Silver
16036.0,88,55,758.9199999999998,3,2,2,7,Gold
16037.0,270,39,855.0200000000001,4,3,2,9,Silver
16038.0,8,26,471.78,1,3,3,7,Gold
16040.0,66,65,1313.5500000000002,3,2,2,7,Gold
16041.0,31,6,3166.4,2,4,1,7,Gold
16042.0,23,70,1177.47,2,2,2,6,Gold
16043.0,38,39,773.99,2,3,2,7,Gold
16045.0,120,83,1340.7,3,2,2,7,Gold
16048.0,374,8,256.44000000000005,4,4,4,12,Bronze
16049.0,41,299,1074.81,2,1,2,5,Platinum
16050.0,174,10,137.89999999999998,4,4,4,12,Bronze
16052.0,55,34,362.05999999999995,3,3,3,9,Silver
16053.0,33,84,1511.9500000000003,2,2,2,6,Gold
16054.0,146,70,783.9000000000001,4,2,2,8,Gold
16055.0,221,8,134.8,4,4,4,12,Bronze
16056.0,46,66,650.75,2,2,3,7,Gold
16057.0,17,121,2263.12,1,1,1,3,Platinum
16059.0,66,178,1453.1599999999999,3,1,2,6,Gold
16062.0,10,64,1153.62,1,2,2,5,Platinum
16063.0,261,23,335.32000000000005,4,3,3,10,Silver
16065.0,366,73,367.14,4,2,3,9,Silver
16066.0,17,101,1521.0400000000004,1,1,2,4,Platinum
16070.0,23,33,852.15,2,3,2,7,Gold
16071.0,45,21,326.24,2,3,3,8,Gold
16072.0,289,23,584.32,4,3,3,10,Silver
16073.0,298,1,122.39999999999999,4,4,4,12,Bronze
16076.0,4,129,2234.73,1,1,1,3,Platinum
16078.0,284,1,79.2,4,4,4,12,Bronze
16079.0,17,21,1352.0000000000002,1,3,2,6,Gold
16080.0,82,10,217.16000000000003,3,4,4,11,Bronze
16081.0,57,223,2799.42,3,1,1,5,Platinum
16083.0,101,31,1317.62,3,3,2,8,Gold
16084.0,300,38,436.18,4,3,3,10,Silver
16085.0,24,167,981.51,2,1,2,5,Platinum
16086.0,60,39,1121.3899999999999,3,3,2,8,Gold
16091.0,155,18,315.06,4,3,3,10,Silver
16092.0,115,51,817.86,3,2,2,7,Gold
16093.0,107,1,17.0,3,4,4,11,Bronze
16094.0,12,63,1078.2299999999998,1,2,2,5,Platinum
16096.0,265,12,320.62,4,4,3,11,Bronze
16097.0,241,10,185.05,4,4,4,12,Bronze
16098.0,88,67,2005.63,3,2,1,6,Gold
16099.0,51,39,731.8999999999997,2,3,2,7,Gold
16101.0,71,76,1290.6999999999998,3,2,2,7,Gold
16102.0,43,57,1842.14,2,2,1,5,Platinum
16103.0,8,48,1429.6399999999999,1,2,2,5,Platinum
16104.0,62,28,298.21000000000004,3,3,4,10,Silver
16105.0,249,13,336.96,4,4,3,11,Bronze
16106.0,66,6,108.38,3,4,4,11,Bronze
16107.0,18,31,3204.16,1,3,1,5,Platinum
16108.0,85,48,842.5,3,2,2,7,Gold
16109.0,219,18,611.8800000000001,4,3,3,10,Silver
16110.0,46,342,1320.9500000000003,2,1,2,5,Platinum
16112.0,144,16,195.74,4,4,4,12,Bronze
16113.0,184,30,161.38,4,3,4,11,Bronze
16114.0,171,8,135.75000000000003,4,4,4,12,Bronze
16115.0,10,279,1660.8799999999999,1,1,1,3,Platinum
16116.0,212,34,612.7800000000001,4,3,3,10,Silver
16117.0,190,30,232.21,4,3,4,11,Bronze
16119.0,9,16,423.36,1,4,3,8,Gold
16120.0,60,30,1309.14,3,3,2,8,Gold
16121.0,58,204,854.66,3,1,2,6,Gold
16122.0,74,38,684.42,3,3,2,8,Gold
16123.0,52,16,307.78000000000003,3,4,3,10,Silver
16124.0,318,11,249.0,4,4,4,12,Bronze
16125.0,368,13,289.35,4,4,4,12,Bronze
16126.0,30,117,6287.77,2,1,1,4,Platinum
16127.0,40,40,656.25,2,3,3,8,Gold
16128.0,18,89,1880.2199999999998,1,2,1,4,Platinum
16131.0,52,78,3506.540000000001,3,2,1,6,Gold
16133.0,4,338,14589.039999999999,1,1,1,3,Platinum
16134.0,22,35,618.09,2,3,3,8,Gold
16135.0,263,21,517.5500000000001,4,3,3,10,Silver
16136.0,60,37,709.3800000000002,3,3,2,8,Gold
16139.0,19,31,635.4100000000001,2,3,3,8,Gold
16140.0,66,35,725.1800000000001,3,3,2,8,Gold
16141.0,89,30,620.4,3,3,3,9,Silver
16142.0,250,37,535.3399999999999,4,3,3,10,Silver
16143.0,4,117,2424.94,1,1,1,3,Platinum
16144.0,247,1,175.2,4,4,4,12,Bronze
16145.0,9,224,3799.4900000000002,1,1,1,3,Platinum
16146.0,158,29,734.1299999999999,4,3,2,9,Silver
16147.0,134,22,374.99999999999994,3,3,3,9,Silver
16148.0,297,1,76.32000000000001,4,4,4,12,Bronze
16149.0,5,18,280.52000000000004,1,3,4,8,Gold
16150.0,43,117,2053.02,2,1,1,4,Platinum
16152.0,269,29,1829.0399999999997,4,3,1,8,Gold
16153.0,50,89,1824.23,2,2,1,5,Platinum
16156.0,9,128,3092.04,1,1,1,3,Platinum
16157.0,16,18,656.6899999999999,1,3,3,7,Gold
16159.0,282,14,348.2000000000001,4,4,3,11,Bronze
16160.0,66,20,1025.44,3,3,2,8,Gold
16161.0,2,471,5533.67,1,1,1,3,Platinum
16162.0,253,2,37.4,4,4,4,12,Bronze
16163.0,233,6,856.6000000000001,4,4,2,10,Silver
16164.0,18,34,822.48,1,3,2,6,Gold
16168.0,11,98,3787.6000000000004,1,2,1,4,Platinum
16169.0,9,85,1822.9700000000003,1,2,1,4,Platinum
16170.0,51,125,1885.0500000000004,2,1,1,4,Platinum
16171.0,60,3,73.2,3,4,4,11,Bronze
16172.0,96,69,1140.2100000000003,3,2,2,7,Gold
16173.0,16,84,1418.32,1,2,2,5,Platinum
16174.0,127,23,1009.55,3,3,2,8,Gold
16175.0,95,58,1037.5900000000001,3,2,2,7,Gold
16177.0,51,15,331.95,2,4,3,9,Silver
16178.0,139,8,197.9,3,4,4,11,Bronze
16179.0,61,11,215.83,3,4,4,11,Bronze
16180.0,101,162,10254.18,3,1,1,5,Platinum
16181.0,74,11,305.5400000000001,3,4,4,11,Bronze
16182.0,73,28,6617.65,3,3,1,7,Gold
16183.0,68,15,338.7100000000001,3,4,3,10,Silver
16184.0,65,45,1158.79,3,2,2,7,Gold
16185.0,17,31,529.4100000000001,1,3,3,7,Gold
16186.0,23,218,4006.9400000000005,2,1,1,4,Platinum
16187.0,32,295,6911.4400000000005,2,1,1,4,Platinum
16188.0,45,67,981.8599999999999,2,2,2,6,Gold
16189.0,16,11,215.47999999999996,1,4,4,9,Silver
16190.0,41,6,215.08,2,4,4,10,Silver
16191.0,3,134,5180.52,1,1,1,3,Platinum
16193.0,237,19,314.45000000000005,4,3,3,10,Silver
16198.0,76,15,400.681,3,4,3,10,Silver
16200.0,5,172,1068.87,1,1,2,4,Platinum
16201.0,4,111,1863.4700000000003,1,1,1,3,Platinum
16202.0,361,18,365.27,4,3,3,10,Silver
16203.0,59,35,592.9,3,3,3,9,Silver
16204.0,24,50,384.18,2,2,3,7,Gold
16205.0,31,97,757.63,2,2,2,6,Gold
16206.0,55,63,537.0600000000001,3,2,3,8,Gold
16207.0,26,19,394.38,2,3,3,8,Gold
16208.0,45,66,664.26,2,2,3,7,Gold
16209.0,89,46,2262.6199999999994,3,2,1,6,Gold
16210.0,2,123,21086.300000000003,1,1,1,3,Platinum
16211.0,89,23,547.0200000000001,3,3,3,9,Silver
16212.0,20,41,690.3399999999999,2,3,2,7,Gold
16213.0,79,6,159.0,3,4,4,11,Bronze
16214.0,171,44,1062.75,4,2,2,8,Gold
16215.0,81,14,242.35000000000002,3,4,4,11,Bronze
16216.0,268,37,914.9299999999998,4,3,2,9,Silver
16217.0,236,15,304.25000000000006,4,4,4,12,Bronze
16218.0,30,84,3084.68,2,2,1,5,Platinum
16221.0,37,95,860.86,2,2,2,6,Gold
16222.0,319,122,773.5500000000001,4,1,2,7,Gold
16224.0,58,96,1295.3,3,2,2,7,Gold
16225.0,45,134,1096.3200000000002,2,1,2,5,Platinum
16226.0,204,8,255.12,4,4,4,12,Bronze
16227.0,226,6,314.22,4,4,3,11,Bronze
16229.0,88,47,1010.5999999999998,3,2,2,7,Gold
16230.0,190,35,542.03,4,3,3,10,Silver
16232.0,44,37,990.8799999999999,2,3,2,7,Gold
16233.0,72,22,536.68,3,3,3,9,Silver
16235.0,41,46,867.3099999999998,2,2,2,6,Gold
16236.0,79,20,432.19999999999993,3,3,3,9,Silver
16239.0,57,19,414.2,3,3,3,9,Silver
16240.0,25,135,3718.8,2,1,1,4,Platinum
16241.0,10,655,2590.3100000000004,1,1,1,3,Platinum
16242.0,9,292,3579.8599999999997,1,1,1,3,Platinum
16243.0,34,51,409.1,2,2,3,7,Gold
16244.0,212,91,1522.75,4,2,2,8,Gold
16245.0,24,90,1413.66,2,2,2,6,Gold
16247.0,171,16,114.56,4,4,4,12,Bronze
16248.0,62,7,152.94,3,4,4,11,Bronze
16249.0,53,69,1800.0700000000002,3,2,1,6,Gold
16250.0,262,24,389.44,4,3,3,10,Silver
16253.0,67,123,3683.8599999999997,3,1,1,5,Platinum
16255.0,17,270,2619.91,1,1,1,3,Platinum
16256.0,267,13,752.4300000000002,4,4,2,10,Silver
16257.0,177,2,46.95,4,4,4,12,Bronze
16258.0,46,135,5203.510000000001,2,1,1,4,Platinum
16260.0,51,18,1035.45,2,3,2,7,Gold
16261.0,18,119,728.5400000000001,1,1,2,4,Platinum
16265.0,10,258,5447.0,1,1,1,3,Platinum
16266.0,74,61,861.8899999999999,3,2,2,7,Gold
16268.0,72,45,667.6500000000001,3,2,3,8,Gold
16270.0,354,54,1141.2399999999996,4,2,2,8,Gold
16271.0,3,130,1404.64,1,1,2,4,Platinum
16272.0,117,25,411.7,3,3,3,9,Silver
16274.0,374,65,351.75,4,2,3,9,Silver
16275.0,197,33,559.87,4,3,3,10,Silver
16276.0,177,6,810.6000000000001,4,4,2,10,Silver
16278.0,101,23,566.38,3,3,3,9,Silver
16279.0,22,106,1502.78,2,1,2,5,Platinum
16281.0,73,17,2062.0600000000004,3,4,1,8,Gold
16282.0,340,11,168.3,4,4,4,12,Bronze
16283.0,6,166,1570.81,1,1,2,4,Platinum
16284.0,32,103,812.68,2,1,2,5,Platinum
16287.0,170,8,142.5,4,4,4,12,Bronze
16292.0,122,17,302.25,3,4,4,11,Bronze
16293.0,22,118,2248.99,2,1,1,4,Platinum
16295.0,10,79,1328.5500000000004,1,2,2,5,Platinum
16297.0,269,20,301.90000000000003,4,3,4,11,Bronze
16298.0,23,27,598.1999999999999,2,3,3,8,Gold
16302.0,127,11,233.22,3,4,4,11,Bronze
16303.0,26,162,5360.630000000001,2,1,1,4,Platinum
16305.0,139,22,361.21999999999986,3,3,3,9,Silver
16306.0,214,41,632.27,4,3,3,10,Silver
16308.0,38,4,2560.0,2,4,1,7,Gold
16309.0,107,42,706.57,3,2,2,7,Gold
16311.0,18,37,616.26,1,3,3,7,Gold
16313.0,4,16,274.15000000000003,1,4,4,9,Silver
16315.0,331,14,226.37,4,4,4,12,Bronze
16316.0,65,151,2938.91,3,1,1,5,Platinum
16317.0,120,69,1341.65,3,2,2,7,Gold
16318.0,36,19,328.15,2,3,3,8,Gold
16319.0,218,3,404.40000000000003,4,4,3,11,Bronze
16320.0,173,56,1038.46,4,2,2,8,Gold
16321.0,73,12,373.65,3,4,3,10,Silver
16322.0,2,37,326.74999999999994,1,3,3,7,Gold
16323.0,197,1,207.50000000000003,4,4,4,12,Bronze
16324.0,129,111,408.58999999999986,3,1,3,7,Gold
16325.0,47,18,594.24,2,3,3,8,Gold
16326.0,6,300,3039.2200000000003,1,1,1,3,Platinum
16327.0,15,317,3820.27,1,1,1,3,Platinum
16330.0,18,39,251.91,1,3,4,8,Gold
16332.0,29,151,1582.8,2,1,2,5,Platinum
16333.0,8,45,26626.8,1,2,1,4,Platinum
16337.0,37,10,151.05,2,4,4,10,Silver
16338.0,158,11,214.8,4,4,4,12,Bronze
16339.0,285,18,94.05000000000001,4,3,4,11,Bronze
16340.0,108,141,534.31,3,1,3,7,Gold
16341.0,25,77,1971.87,2,2,1,5,Platinum
16342.0,76,15,322.41,3,4,3,10,Silver
16343.0,17,43,328.58000000000004,1,2,3,6,Gold
16344.0,159,2,101.10000000000001,4,4,4,12,Bronze
16345.0,45,37,565.46,2,3,3,8,Gold
16347.0,12,85,847.45,1,2,2,5,Platinum
16348.0,33,222,1415.65,2,1,2,5,Platinum
16349.0,291,9,53.5,4,4,4,12,Bronze
16350.0,22,57,1116.47,2,2,2,6,Gold
16351.0,333,8,153.9,4,4,4,12,Bronze
16352.0,18,28,494.44,1,3,3,7,Gold
16353.0,4,94,6675.710000000001,1,2,1,4,Platinum
16354.0,64,39,395.8,3,3,3,9,Silver
16356.0,198,31,211.77,4,3,4,11,Bronze
16357.0,34,34,658.88,2,3,3,8,Gold
16358.0,2,109,2027.5,1,1,1,3,Platinum
16359.0,8,66,1750.9200000000003,1,2,1,4,Platinum
16360.0,5,636,3450.41,1,1,1,3,Platinum
16361.0,10,104,891.21,1,1,2,4,Platinum
16362.0,33,77,709.99,2,2,2,6,Gold
16363.0,54,5,109.36000000000001,3,4,4,11,Bronze
16364.0,12,52,705.7899999999998,1,2,2,5,Platinum
16365.0,18,51,1540.42,1,2,2,5,Platinum
16366.0,19,18,327.3,2,3,3,8,Gold
16367.0,38,127,800.6699999999996,2,1,2,5,Platinum
16368.0,3,69,479.90999999999997,1,2,3,6,Gold
16369.0,19,117,1545.4100000000003,2,1,2,5,Platinum
16370.0,83,221,1301.9099999999999,3,1,2,6,Gold
16372.0,34,92,355.72999999999996,2,2,3,7,Gold
16374.0,67,109,466.72999999999996,3,1,3,7,Gold
16376.0,9,122,974.9599999999999,1,1,2,4,Platinum
16377.0,268,5,676.2,4,4,2,10,Silver
16378.0,248,23,362.9500000000001,4,3,3,10,Silver
16379.0,5,108,2157.4000000000005,1,1,1,3,Platinum
16380.0,62,31,1743.15,3,3,1,7,Gold
16383.0,75,98,643.7599999999999,3,2,3,8,Gold
16384.0,90,33,584.5,3,3,3,9,Silver
16385.0,61,57,554.8599999999999,3,2,3,8,Gold
16386.0,29,81,302.56999999999994,2,2,4,8,Gold
16387.0,323,4,94.36,4,4,4,12,Bronze
16389.0,54,34,1382.0699999999997,3,3,2,8,Gold
16392.0,270,43,217.89,4,2,4,10,Silver
16393.0,3,327,3040.96,1,1,1,3,Platinum
16394.0,57,83,1555.3400000000001,3,2,2,7,Gold
16395.0,61,206,1482.0600000000002,3,1,2,6,Gold
16398.0,155,82,1705.8,4,2,1,7,Gold
16399.0,20,72,408.02,2,2,3,7,Gold
16400.0,95,29,303.93,3,3,4,10,Silver
16401.0,2,186,4098.32,1,1,1,3,Platinum
16402.0,265,57,293.45,4,2,4,10,Silver
16403.0,313,10,177.5,4,4,4,12,Bronze
16404.0,71,23,443.05000000000007,3,3,3,9,Silver
16405.0,303,5,167.25,4,4,4,12,Bronze
16406.0,19,58,154.35000000000002,2,2,4,8,Gold
16407.0,13,168,2079.6800000000003,1,1,1,3,Platinum
16409.0,37,231,2022.9800000000002,2,1,1,4,Platinum
16411.0,20,44,211.7,2,2,4,8,Gold
16412.0,54,30,135.99,3,3,4,10,Silver
16413.0,57,31,262.2,3,3,4,10,Silver
16414.0,22,7,126.25,2,4,4,10,Silver
16415.0,45,47,200.26999999999995,2,2,4,8,Gold
16416.0,27,71,1051.4,2,2,2,6,Gold
16418.0,45,95,631.1200000000001,2,2,3,7,Gold
16419.0,113,50,958.71,3,2,2,7,Gold
16422.0,18,369,34684.4,1,1,1,3,Platinum
16423.0,25,18,346.12,2,3,3,8,Gold
16424.0,192,5,133.56,4,4,4,12,Bronze
16425.0,303,21,302.69999999999993,4,3,4,11,Bronze
16426.0,3,353,1863.76,1,1,1,3,Platinum
16427.0,264,9,241.06,4,4,4,12,Bronze
16429.0,107,2,284.55,3,4,4,11,Bronze
16430.0,58,6,300.85,3,4,4,11,Bronze
16431.0,214,76,623.2799999999999,4,2,3,9,Silver
16432.0,65,8,287.4,3,4,4,11,Bronze
16433.0,29,17,184.26,2,4,4,10,Silver
16434.0,30,107,1511.8000000000002,2,1,2,5,Platinum
16438.0,6,132,798.35,1,1,2,4,Platinum
16440.0,8,282,3640.6699999999996,1,1,1,3,Platinum
16441.0,68,24,381.2,3,3,3,9,Silver
16442.0,2,171,609.3,1,1,3,5,Platinum
16444.0,47,84,654.6700000000001,2,2,3,7,Gold
16445.0,34,63,230.51000000000002,2,2,4,8,Gold
16446.0,1,3,168472.5,1,4,1,6,Gold
16447.0,136,34,255.91,3,3,4,10,Silver
16448.0,199,19,182.99,4,3,4,11,Bronze
16449.0,198,40,707.69,4,3,2,9,Silver
16450.0,150,11,311.92,4,4,3,11,Bronze
16451.0,88,14,266.97,3,4,4,11,Bronze
16454.0,45,2,6.9,2,4,4,10,Silver
16455.0,64,99,1841.18,3,1,1,5,Platinum
16456.0,100,110,2158.1800000000003,3,1,1,5,Platinum
16457.0,219,9,208.35999999999999,4,4,4,12,Bronze
16458.0,3,202,3482.7400000000007,1,1,1,3,Platinum
16460.0,29,132,811.23,2,1,2,5,Platinum
16461.0,178,32,142.92,4,3,4,11,Bronze
16462.0,74,3,136.0,3,4,4,11,Bronze
16463.0,22,82,1422.4,2,2,2,6,Gold
16464.0,20,230,1298.66,2,1,2,5,Platinum
16466.0,34,146,1595.96,2,1,2,5,Platinum
16468.0,75,2,74.9,3,4,4,11,Bronze
16469.0,24,171,625.4200000000001,2,1,3,6,Gold
16470.0,52,164,752.77,3,1,2,6,Gold
16471.0,275,13,223.95,4,4,4,12,Bronze
16473.0,165,18,316.11,4,3,3,10,Silver
16474.0,8,337,1810.65,1,1,1,3,Platinum
16475.0,89,28,544.3,3,3,3,9,Silver
16477.0,64,146,2494.46,3,1,1,5,Platinum
16478.0,26,17,331.0,2,4,3,9,Silver
16479.0,11,35,300.83,1,3,4,8,Gold
16480.0,76,53,769.29,3,2,2,7,Gold
16482.0,16,18,220.62,1,3,4,8,Gold
16483.0,193,19,139.35,4,3,4,11,Bronze
16484.0,174,25,404.30000000000007,4,3,3,10,Silver
16485.0,78,42,363.65,3,2,3,8,Gold
16488.0,34,29,498.79999999999995,2,3,3,8,Gold
16491.0,47,39,731.5,2,3,2,7,Gold
16493.0,80,56,1351.63,3,2,2,7,Gold
16494.0,297,50,826.5299999999999,4,2,2,8,Gold
16495.0,4,88,648.26,1,2,3,6,Gold
16496.0,9,95,1599.52,1,2,2,5,Platinum
16497.0,50,136,2965.69,2,1,1,4,Platinum
16498.0,162,15,100.97000000000001,4,4,4,12,Bronze
16499.0,361,19,365.45000000000005,4,3,3,10,Silver
16500.0,5,11,400.86,1,4,3,8,Gold
16503.0,107,84,1431.9299999999998,3,2,2,7,Gold
16504.0,26,83,465.88000000000005,2,2,3,7,Gold
16505.0,32,4,777.6,2,4,2,8,Gold
16506.0,20,3,90.30000000000001,2,4,4,10,Silver
16509.0,297,13,363.70000000000005,4,4,3,11,Bronze
16510.0,373,13,248.10000000000002,4,4,4,12,Bronze
16511.0,22,159,918.33,2,1,2,5,Platinum
16513.0,5,35,874.5899999999999,1,3,2,6,Gold
16515.0,53,111,1624.14,3,1,2,6,Gold
16516.0,31,6,101.7,2,4,4,10,Silver
16517.0,278,17,162.70000000000005,4,4,4,12,Bronze
16518.0,62,40,484.32000000000005,3,3,3,9,Silver
16519.0,26,13,215.08,2,4,4,10,Silver
16520.0,187,156,1046.57,4,1,2,7,Gold
16523.0,2,290,9418.470000000001,1,1,1,3,Platinum
16525.0,3,183,13027.45,1,1,1,3,Platinum
16526.0,172,15,290.35999999999996,4,4,4,12,Bronze
16527.0,82,14,228.06000000000003,3,4,4,11,Bronze
16528.0,4,17,244.41000000000003,1,4,4,9,Silver
16529.0,191,30,455.25,4,3,3,10,Silver
16531.0,23,77,1244.59,2,2,2,6,Gold
16532.0,18,4,6748.8,1,4,1,6,Gold
16533.0,20,176,1082.81,2,1,2,5,Platinum
16535.0,6,31,593.75,1,3,3,7,Gold
16536.0,111,54,548.12,3,2,3,8,Gold
16539.0,3,45,1388.81,1,2,2,5,Platinum
16542.0,54,5,119.62,3,4,4,11,Bronze
16545.0,165,3,339.3,4,4,3,11,Bronze
16546.0,291,25,787.15,4,3,2,9,Silver
16549.0,11,925,4034.9,1,1,1,3,Platinum
16550.0,109,251,2298.97,3,1,1,5,Platinum
16551.0,96,32,922.12,3,3,2,8,Gold
16552.0,243,17,379.73,4,4,3,11,Bronze
16553.0,164,84,5719.82,4,2,1,7,Gold
16554.0,43,52,837.0999999999999,2,2,2,6,Gold
16555.0,36,17,285.89,2,4,4,10,Silver
16556.0,67,207,3313.79,3,1,1,5,Platinum
16557.0,25,11,281.84999999999997,2,4,4,10,Silver
16558.0,1,460,8338.490000000002,1,1,1,3,Platinum
16560.0,27,56,841.4100000000001,2,2,2,6,Gold
16561.0,6,31,511.12,1,3,3,7,Gold
16563.0,54,19,1077.74,3,3,2,8,Gold
16565.0,365,3,173.7,4,4,4,12,Bronze
16566.0,16,18,614.6600000000001,1,3,3,7,Gold
16567.0,195,35,865.6,4,3,2,9,Silver
16569.0,4,5,124.2,1,4,4,9,Silver
16570.0,16,126,3738.4,1,1,1,3,Platinum
16571.0,27,87,1421.69,2,2,2,6,Gold
16572.0,128,57,1009.6,3,2,2,7,Gold
16573.0,85,42,663.61,3,2,3,8,Gold
16574.0,72,28,451.43999999999994,3,3,3,9,Silver
16581.0,183,9,105.84,4,4,4,12,Bronze
16582.0,114,6,313.61999999999995,3,4,3,10,Silver
16583.0,374,14,233.45000000000002,4,4,4,12,Bronze
16584.0,81,28,936.0799999999998,3,3,2,8,Gold
16586.0,249,8,463.95,4,4,3,11,Bronze
16587.0,233,13,225.14999999999995,4,4,4,12,Bronze
16589.0,72,33,459.24,3,3,3,9,Silver
16591.0,69,10,213.5,3,4,4,11,Bronze
16592.0,5,216,4113.68,1,1,1,3,Platinum
16593.0,51,27,330.03000000000003,2,3,3,8,Gold
16594.0,76,53,181.09,3,2,4,9,Silver
16595.0,62,85,360.15999999999997,3,2,3,8,Gold
16596.0,16,12,250.14999999999998,1,4,4,9,Silver
16597.0,5,7,90.04000000000002,1,4,4,9,Silver
16598.0,286,10,145.05,4,4,4,12,Bronze
16600.0,5,62,813.5199999999999,1,2,2,5,Platinum
16601.0,41,30,242.69999999999996,2,3,4,9,Silver
16602.0,37,29,528.0799999999999,2,3,3,8,Gold
16603.0,75,34,482.47,3,3,3,9,Silver
16607.0,18,172,3347.71,1,1,1,3,Platinum
16609.0,16,276,5493.46,1,1,1,3,Platinum
16610.0,220,6,75.66,4,4,4,12,Bronze
16611.0,187,10,129.49,4,4,4,12,Bronze
16612.0,33,66,1187.6599999999999,2,2,2,6,Gold
16613.0,71,30,618.5900000000001,3,3,3,9,Silver
16614.0,183,26,506.19,4,3,3,10,Silver
16616.0,16,33,500.42,1,3,3,7,Gold
16617.0,236,5,151.85000000000002,4,4,4,12,Bronze
16618.0,32,96,2647.5899999999997,2,2,1,5,Platinum
16619.0,264,14,226.21,4,4,4,12,Bronze
16620.0,4,9,178.96,1,4,4,9,Silver
16621.0,52,29,813.4800000000001,3,3,2,8,Gold
16623.0,246,5,129.45,4,4,4,12,Bronze
16624.0,81,48,810.5699999999999,3,2,2,7,Gold
16625.0,275,23,333.08,4,3,3,10,Silver
16626.0,1,179,4413.1,1,1,1,3,Platinum
16627.0,80,20,322.80000000000007,3,3,3,9,Silver
16628.0,30,117,2188.05,2,1,1,4,Platinum
16629.0,74,60,408.63,3,2,3,8,Gold
16633.0,18,152,2883.1000000000004,1,1,1,3,Platinum
16634.0,223,9,217.9,4,4,4,12,Bronze
16637.0,33,69,1154.4700000000003,2,2,2,6,Gold
16638.0,23,94,1680.72,2,2,1,5,Platinum
16639.0,32,50,1257.51,2,2,2,6,Gold
16641.0,106,12,231.10000000000002,3,4,4,11,Bronze
16642.0,5,34,688.33,1,3,2,6,Gold
16643.0,246,27,487.51,4,3,3,10,Silver
16644.0,178,62,833.78,4,2,2,8,Gold
16647.0,170,14,214.06,4,4,4,12,Bronze
16648.0,43,19,290.65999999999997,2,3,4,9,Silver
16650.0,72,24,518.4200000000001,3,3,3,9,Silver
16652.0,59,118,6773.97,3,1,1,5,Platinum
16653.0,17,69,1212.6600000000003,1,2,2,5,Platinum
16654.0,142,29,601.2699999999999,3,3,3,9,Silver
16655.0,18,258,3789.52,1,1,1,3,Platinum
16656.0,23,73,8625.800000000001,2,2,1,5,Platinum
16657.0,10,192,874.43,1,1,2,4,Platinum
16658.0,369,8,123.24,4,4,4,12,Bronze
16659.0,190,2,39.12,4,4,4,12,Bronze
16660.0,17,16,1267.6499999999999,1,4,2,7,Gold
16665.0,363,9,135.39999999999998,4,4,4,12,Bronze
16666.0,20,32,118.97999999999999,2,3,4,9,Silver
16667.0,69,52,567.18,3,2,3,8,Gold
16668.0,16,20,306.71999999999997,1,3,3,7,Gold
16669.0,24,156,1348.88,2,1,2,5,Platinum
16670.0,17,252,4095.9,1,1,1,3,Platinum
16671.0,29,6,1692.27,2,4,1,7,Gold
16672.0,3,114,8134.94,1,1,1,3,Platinum
16674.0,55,93,304.24,3,2,4,9,Silver
16676.0,34,89,1592.12,2,2,2,6,Gold
16678.0,3,163,3109.99,1,1,1,3,Platinum
16679.0,367,3,129.75,4,4,4,12,Bronze
16680.0,44,10,183.7,2,4,4,10,Silver
16681.0,73,44,1770.3400000000001,3,2,1,6,Gold
16682.0,5,30,1027.9999999999998,1,3,2,6,Gold
16684.0,5,277,66653.56,1,1,1,3,Platinum
16685.0,62,62,324.24,3,2,3,8,Gold
16686.0,48,544,2959.88,2,1,1,4,Platinum
16688.0,2,62,1260.86,1,2,2,5,Platinum
16689.0,76,13,422.59999999999997,3,4,3,10,Silver
16690.0,73,12,225.57999999999996,3,4,4,11,Bronze
16692.0,257,3,1276.0,4,4,2,10,Silver
16693.0,69,59,477.85999999999996,3,2,3,8,Gold
16696.0,136,10,657.9000000000001,3,4,3,10,Silver
16697.0,242,21,112.75000000000001,4,3,4,11,Bronze
16698.0,227,5,1998.0,4,4,1,9,Silver
16700.0,9,308,5076.550000000001,1,1,1,3,Platinum
16701.0,9,144,5398.299999999999,1,1,1,3,Platinum
16705.0,1,270,14034.990000000002,1,1,1,3,Platinum
16706.0,38,123,531.3499999999999,2,1,3,6,Gold
16708.0,46,27,656.6300000000001,2,3,3,8,Gold
16709.0,85,79,3029.8700000000003,3,2,1,6,Gold
16710.0,20,394,2467.99,2,1,1,4,Platinum
16711.0,4,22,1651.03,1,3,2,6,Gold
16712.0,10,438,3611.31,1,1,1,3,Platinum
16713.0,19,619,6910.78,2,1,1,4,Platinum
16714.0,219,87,1129.06,4,2,2,8,Gold
16715.0,79,19,301.71999999999997,3,3,4,10,Silver
16716.0,267,2,901.2,4,4,2,10,Silver
16717.0,24,198,3843.0800000000004,2,1,1,4,Platinum
16718.0,370,44,606.0500000000001,4,2,3,9,Silver
16719.0,15,196,1770.22,1,1,1,3,Platinum
16720.0,27,25,152.95,2,3,4,9,Silver
16721.0,263,37,292.46999999999997,4,3,4,11,Bronze
16722.0,18,225,4730.8099999999995,1,1,1,3,Platinum
16723.0,92,42,576.4,3,2,3,8,Gold
16725.0,303,145,758.27,4,1,2,7,Gold
16726.0,27,178,1358.7400000000002,2,1,2,5,Platinum
16727.0,365,44,256.31999999999994,4,2,4,10,Silver
16728.0,47,263,1048.28,2,1,2,5,Platinum
16729.0,39,656,7205.33,2,1,1,4,Platinum
16730.0,53,82,743.11,3,2,2,7,Gold
16732.0,32,28,603.7499999999999,2,3,3,8,Gold
16734.0,53,52,646.76,3,2,3,8,Gold
16735.0,79,116,2247.4100000000003,3,1,1,5,Platinum
16737.0,54,1,417.59999999999997,3,4,3,10,Silver
16738.0,298,1,3.75,4,4,4,12,Bronze
16739.0,177,13,323.00000000000006,4,4,3,11,Bronze
16742.0,47,1,464.9,2,4,3,9,Silver
16743.0,30,190,2213.13,2,1,1,4,Platinum
16744.0,12,236,1291.9099999999999,1,1,2,4,Platinum
16745.0,87,355,7180.7,3,1,1,5,Platinum
16746.0,5,444,6680.110000000001,1,1,1,3,Platinum
16747.0,38,42,836.06,2,2,2,6,Gold
16748.0,18,69,1515.8999999999999,1,2,2,5,Platinum
16750.0,45,95,623.9300000000001,2,2,3,7,Gold
16751.0,31,25,1764.7199999999998,2,3,1,6,Gold
16752.0,373,9,207.5,4,4,4,12,Bronze
16753.0,59,34,223.92,3,3,4,10,Silver
16754.0,373,2,2002.4,4,4,1,9,Silver
16755.0,115,165,1475.4299999999998,3,1,2,6,Gold
16756.0,215,13,239.40000000000003,4,4,4,12,Bronze
16757.0,319,7,106.83,4,4,4,12,Bronze
16758.0,66,22,369.34000000000003,3,3,3,9,Silver
16759.0,8,42,789.79,1,2,2,5,Platinum
16761.0,97,13,316.62,3,4,3,10,Silver
16762.0,20,63,1207.24,2,2,2,6,Gold
16763.0,199,23,611.8500000000001,4,3,3,10,Silver
16764.0,4,700,2790.9500000000003,1,1,1,3,Platinum
16765.0,295,1,34.0,4,4,4,12,Bronze
16766.0,274,34,1145.5999999999997,4,3,2,9,Silver
16767.0,31,221,5575.5599999999995,2,1,1,4,Platinum
16768.0,48,54,478.0899999999999,2,2,3,7,Gold
16769.0,261,38,361.5399999999999,4,3,3,10,Silver
16770.0,58,140,757.0999999999999,3,1,2,6,Gold
16771.0,34,254,2242.6099999999997,2,1,1,4,Platinum
16773.0,58,26,171.59,3,3,4,10,Silver
16774.0,68,48,661.52,3,2,3,8,Gold
16775.0,11,157,1691.5100000000002,1,1,1,3,Platinum
16776.0,61,71,371.54,3,2,3,8,Gold
16777.0,81,48,222.62,3,2,4,9,Silver
16778.0,75,16,245.94,3,4,4,11,Bronze
16779.0,3,331,10611.720000000001,1,1,1,3,Platinum
16780.0,101,59,422.24,3,2,3,8,Gold
16781.0,373,17,311.25,4,4,3,11,Bronze
16782.0,11,183,2267.95,1,1,1,3,Platinum
16784.0,20,3,107.6,2,4,4,10,Silver
16788.0,124,148,594.3899999999999,3,1,3,7,Gold
16789.0,9,5,80.8,1,4,4,9,Silver
16790.0,4,93,1545.6200000000001,1,2,2,5,Platinum
16791.0,30,314,1705.7799999999997,2,1,1,4,Platinum
16792.0,283,12,110.38000000000001,4,4,4,12,Bronze
16793.0,58,16,243.84,3,4,4,11,Bronze
16794.0,2,278,1196.5,1,1,2,4,Platinum
16795.0,366,66,414.87999999999994,4,2,3,9,Silver
16796.0,90,18,305.61999999999995,3,3,4,10,Silver
16800.0,12,156,1162.65,1,1,2,4,Platinum
16801.0,164,75,1594.23,4,2,2,8,Gold
16803.0,66,24,332.3,3,3,3,9,Silver
16804.0,24,60,536.99,2,2,3,7,Gold
16805.0,174,98,460.5899999999999,4,2,3,9,Silver
16806.0,104,93,762.1600000000001,3,2,2,7,Gold
16807.0,143,67,1121.59,4,2,2,8,Gold
16808.0,100,23,288.42,3,3,4,10,Silver
16809.0,24,149,914.69,2,1,2,5,Platinum
16810.0,193,15,309.53999999999996,4,4,3,11,Bronze
16811.0,5,28,547.0699999999999,1,3,3,7,Gold
16812.0,361,15,479.3500000000001,4,4,3,11,Bronze
16813.0,9,426,1652.18,1,1,2,4,Platinum
16814.0,15,319,6416.700000000001,1,1,1,3,Platinum
16816.0,104,28,417.06000000000006,3,3,3,9,Silver
16817.0,3,86,1604.75,1,2,2,5,Platinum
16818.0,11,188,3349.57,1,1,1,3,Platinum
16820.0,96,26,497.61,3,3,3,9,Silver
16823.0,228,38,358.37999999999994,4,3,3,10,Silver
16824.0,16,26,460.64,1,3,3,7,Gold
16825.0,39,28,775.1800000000001,2,3,2,7,Gold
16826.0,52,22,341.70000000000005,3,3,3,9,Silver
16828.0,94,8,128.5,3,4,4,11,Bronze
16829.0,157,11,197.22,4,4,4,12,Bronze
16830.0,39,23,325.90999999999997,2,3,3,8,Gold
16832.0,185,12,199.15,4,4,4,12,Bronze
16833.0,2,47,1106.53,1,2,2,5,Platinum
16834.0,228,24,413.46000000000004,4,3,3,10,Silver
16835.0,129,10,180.85000000000002,3,4,4,11,Bronze
16836.0,40,11,251.87,2,4,4,10,Silver
16837.0,32,165,3170.9799999999996,2,1,1,4,Platinum
16838.0,198,25,588.85,4,3,3,10,Silver
16839.0,9,266,16594.35,1,1,1,3,Platinum
16841.0,37,116,1869.82,2,1,1,4,Platinum
16842.0,101,63,1264.19,3,2,2,7,Gold
16843.0,43,378,10196.570000000002,2,1,1,4,Platinum
16846.0,51,11,214.32000000000002,2,4,4,10,Silver
16847.0,44,12,193.44,2,4,4,10,Silver
16848.0,53,14,281.42,3,4,4,11,Bronze
16849.0,187,8,124.57,4,4,4,12,Bronze
16850.0,334,19,332.41,4,3,3,10,Silver
16851.0,5,20,342.45000000000005,1,3,3,7,Gold
16852.0,11,9,144.91,1,4,4,9,Silver
16855.0,24,19,328.40000000000003,2,3,3,8,Gold
16856.0,15,2,35.400000000000006,1,4,4,9,Silver
16858.0,369,10,375.69000000000005,4,4,3,11,Bronze
16859.0,145,52,747.8100000000001,4,2,2,8,Gold
16861.0,60,6,173.76,3,4,4,11,Bronze
16863.0,32,26,502.8,2,3,3,8,Gold
16866.0,141,11,207.73999999999998,3,4,4,11,Bronze
16869.0,23,127,817.1200000000001,2,1,2,5,Platinum
16871.0,23,137,2812.34,2,1,1,4,Platinum
16872.0,78,7,680.02,3,4,2,9,Silver
16873.0,5,279,7123.620000000001,1,1,1,3,Platinum
16875.0,68,112,2095.53,3,1,1,5,Platinum
16877.0,13,156,846.62,1,1,2,4,Platinum
16878.0,85,3,13.3,3,4,4,11,Bronze
16880.0,31,174,1491.43,2,1,2,5,Platinum
16881.0,67,1,432.0,3,4,3,10,Silver
16882.0,67,39,705.12,3,3,2,8,Gold
16883.0,188,37,272.47999999999996,4,3,4,11,Bronze
16884.0,38,26,429.84000000000003,2,3,3,8,Gold
16885.0,16,96,450.4100000000001,1,2,3,6,Gold
16887.0,36,36,192.33,2,3,4,9,Silver
16889.0,195,135,1578.67,4,1,2,7,Gold
16891.0,2,186,742.4300000000001,1,1,2,4,Platinum
16892.0,2,97,518.19,1,2,3,6,Gold
16893.0,367,45,145.93,4,2,4,10,Silver
16895.0,65,62,202.26999999999998,3,2,4,9,Silver
16897.0,300,37,289.78,4,3,4,11,Bronze
16898.0,27,157,501.03,2,1,3,6,Gold
16899.0,8,123,1271.06,1,1,2,4,Platinum
16900.0,17,79,887.11,1,2,2,5,Platinum
16902.0,117,44,1706.88,3,2,1,6,Gold
16903.0,30,56,363.2,2,2,3,7,Gold
16904.0,5,665,3653.7500000000005,1,1,1,3,Platinum
16905.0,6,199,3037.6,1,1,1,3,Platinum
16906.0,82,86,559.5900000000003,3,2,3,8,Gold
16907.0,30,140,928.76,2,1,2,5,Platinum
16909.0,73,18,379.14,3,3,3,9,Silver
16910.0,5,545,1508.9599999999998,1,1,2,4,Platinum
16912.0,29,100,2555.5800000000004,2,1,1,4,Platinum
16913.0,291,8,113.44,4,4,4,12,Bronze
16914.0,37,30,183.75999999999996,2,3,4,9,Silver
16915.0,10,57,621.6800000000001,1,2,3,6,Gold
16916.0,24,136,562.41,2,1,3,6,Gold
16917.0,277,9,391.52000000000004,4,4,3,11,Bronze
16918.0,50,128,1068.8200000000002,2,1,2,5,Platinum
16919.0,157,326,2592.25,4,1,1,6,Gold
16921.0,62,55,154.18,3,2,4,9,Silver
16923.0,13,626,7069.08,1,1,1,3,Platinum
16924.0,22,81,829.8900000000001,2,2,2,6,Gold
16926.0,372,14,230.25000000000003,4,4,4,12,Bronze
16927.0,116,6,543.0500000000001,3,4,3,10,Silver
16928.0,81,204,2814.7,3,1,1,5,Platinum
16929.0,4,77,1295.3899999999999,1,2,2,5,Platinum
16930.0,27,53,378.89,2,2,3,7,Gold
16931.0,6,886,4554.870000000001,1,1,1,3,Platinum
16932.0,54,48,150.23,3,2,4,9,Silver
16933.0,2,44,563.23,1,2,3,6,Gold
16934.0,55,61,931.0300000000002,3,2,2,7,Gold
16936.0,26,56,261.90000000000003,2,2,4,8,Gold
16938.0,9,235,2711.6800000000003,1,1,1,3,Platinum
16940.0,53,305,3049.88,3,1,1,5,Platinum
16942.0,13,277,1904.99,1,1,1,3,Platinum
16943.0,212,33,816.7299999999999,4,3,2,9,Silver
16945.0,22,249,4345.5,2,1,1,4,Platinum
16947.0,236,21,406.48,4,3,3,10,Silver
16948.0,139,19,435.02000000000004,3,3,3,9,Silver
16949.0,4,60,1286.2700000000002,1,2,2,5,Platinum
16950.0,57,42,1178.56,3,2,2,7,Gold
16951.0,135,86,1277.7500000000002,3,2,2,7,Gold
16952.0,110,16,167.60999999999999,3,4,4,11,Bronze
16953.0,31,1,20.8,2,4,4,10,Silver
16954.0,1,54,2085.08,1,2,1,4,Platinum
16955.0,185,25,518.67,4,3,3,10,Silver
16956.0,18,16,308.74,1,4,3,8,Gold
16957.0,240,16,416.64,4,4,3,11,Bronze
16959.0,88,7,117.35000000000001,3,4,4,11,Bronze
16960.0,39,101,507.05,2,1,3,6,Gold
16961.0,117,14,234.17000000000002,3,4,4,11,Bronze
16963.0,188,7,110.55000000000001,4,4,4,12,Bronze
16965.0,227,26,201.18999999999994,4,3,4,11,Bronze
16966.0,9,28,2154.9700000000003,1,3,1,5,Platinum
16967.0,190,21,319.02,4,3,3,10,Silver
16968.0,5,31,439.43,1,3,3,7,Gold
16969.0,40,42,650.4100000000001,2,2,3,7,Gold
16971.0,39,41,357.21,2,3,3,8,Gold
16976.0,268,2,251.51999999999998,4,4,4,12,Bronze
16978.0,78,39,344.3299999999999,3,3,3,9,Silver
16979.0,4,89,1852.0,1,2,1,4,Platinum
16980.0,256,81,1028.46,4,2,2,8,Gold
16982.0,61,22,384.06,3,3,3,9,Silver
16983.0,13,143,1905.8700000000001,1,1,1,3,Platinum
16984.0,89,400,4459.52,3,1,1,5,Platinum
16985.0,18,120,5464.119999999999,1,1,1,3,Platinum
16986.0,30,3,1873.2,2,4,1,7,Gold
16987.0,4,128,1616.8000000000002,1,1,2,4,Platinum
16988.0,6,7,126.12,1,4,4,9,Silver
16989.0,8,12,1133.25,1,4,2,7,Gold
16990.0,219,1,179.0,4,4,4,12,Bronze
16992.0,11,93,1614.3099999999997,1,2,2,5,Platinum
16996.0,31,37,1456.9600000000003,2,3,2,7,Gold
16997.0,289,12,702.0,4,4,2,10,Silver
16998.0,150,4,295.0,4,4,4,12,Bronze
16999.0,24,23,484.82,2,3,3,8,Gold
17001.0,1,169,3989.5699999999997,1,1,1,3,Platinum
17002.0,86,49,1493.7300000000002,3,2,2,7,Gold
17004.0,47,43,1312.14,2,2,2,6,Gold
17006.0,5,44,781.78,1,2,2,5,Platinum
17007.0,51,52,889.9299999999998,2,2,2,6,Gold
17010.0,19,11,195.36,2,4,4,10,Silver
17011.0,31,15,270.9,2,4,4,10,Silver
17014.0,9,72,583.4300000000001,1,2,3,6,Gold
17015.0,29,214,1838.6100000000001,2,1,1,4,Platinum
17017.0,3,252,8694.26,1,1,1,3,Platinum
17018.0,41,16,920.1,2,4,2,8,Gold
17019.0,12,228,1258.08,1,1,2,4,Platinum
17022.0,32,7,71.0,2,4,4,10,Silver
17024.0,46,3,95.85,2,4,4,10,Silver
17025.0,61,9,357.77,3,4,3,10,Silver
17026.0,186,4,154.82999999999998,4,4,4,12,Bronze
17027.0,79,148,877.56,3,1,2,6,Gold
17029.0,111,2,716.0,3,4,2,9,Silver
17030.0,64,11,146.87000000000003,3,4,4,11,Bronze
17031.0,12,22,380.35,1,3,3,7,Gold
17033.0,87,28,1030.14,3,3,2,8,Gold
17034.0,17,30,745.5200000000001,1,3,2,6,Gold
17035.0,246,28,433.53,4,3,3,10,Silver
17037.0,88,75,1267.32,3,2,2,7,Gold
17038.0,31,22,112.40000000000002,2,3,4,9,Silver
17040.0,138,15,449.72999999999996,3,4,3,10,Silver
17041.0,27,69,1071.49,2,2,2,6,Gold
17042.0,3,97,1036.5800000000002,1,2,2,5,Platinum
17043.0,33,102,1735.18,2,1,1,4,Platinum
17044.0,26,6,948.48,2,4,2,8,Gold
17045.0,114,22,339.43999999999994,3,3,3,9,Silver
17046.0,158,22,642.0199999999999,4,3,3,10,Silver
17047.0,86,65,1100.8999999999999,3,2,2,7,Gold
17048.0,118,43,925.35,3,2,2,7,Gold
17049.0,3,317,5655.030000000001,1,1,1,3,Platinum
17050.0,97,308,3185.64,3,1,1,5,Platinum
17051.0,195,42,240.89,4,2,4,10,Silver
17052.0,29,83,399.0899999999999,2,2,3,7,Gold
17053.0,131,13,498.47999999999996,3,4,3,10,Silver
17054.0,29,83,1356.3300000000002,2,2,2,6,Gold
17058.0,82,62,1179.8899999999999,3,2,2,7,Gold
17059.0,30,514,3080.39,2,1,1,4,Platinum
17060.0,267,5,234.24,4,4,4,12,Bronze
17061.0,74,99,5232.23,3,1,1,5,Platinum
17062.0,314,69,533.3299999999999,4,2,3,9,Silver
17063.0,22,78,1461.14,2,2,2,6,Gold
17064.0,59,61,855.4499999999999,3,2,2,7,Gold
17068.0,13,296,4552.139999999999,1,1,1,3,Platinum
17069.0,29,143,2709.7,2,1,1,4,Platinum
17070.0,115,62,304.23999999999995,3,2,4,9,Silver
17071.0,29,140,2429.03,2,1,1,4,Platinum
17073.0,18,174,1446.0900000000001,1,1,2,4,Platinum
17075.0,18,77,834.1199999999999,1,2,2,5,Platinum
17076.0,37,25,841.0799999999999,2,3,2,7,Gold
17078.0,37,28,378.20000000000005,2,3,3,8,Gold
17079.0,79,2,118.80000000000001,3,4,4,11,Bronze
17080.0,23,8,287.62,2,4,4,10,Silver
17081.0,26,63,288.91,2,2,4,8,Gold
17082.0,34,81,2003.85,2,2,1,5,Platinum
17083.0,110,52,1405.78,3,2,2,7,Gold
17084.0,36,149,2747.99,2,1,1,4,Platinum
17085.0,124,186,1562.4,3,1,2,6,Gold
17086.0,8,96,2050.08,1,2,1,4,Platinum
17088.0,29,115,1991.0100000000002,2,1,1,4,Platinum
17090.0,5,61,1974.6500000000003,1,2,1,4,Platinum
17091.0,3,195,3827.7600000000007,1,1,1,3,Platinum
17092.0,51,124,1774.0300000000002,2,1,1,4,Platinum
17094.0,323,14,301.99999999999994,4,4,4,12,Bronze
17095.0,23,74,1324.1599999999999,2,2,2,6,Gold
17096.0,16,48,1022.1299999999999,1,2,2,5,Platinum
17097.0,3,211,954.42,1,1,2,4,Platinum
17100.0,19,65,971.74,2,2,2,6,Gold
17101.0,11,42,1621.73,1,2,2,5,Platinum
17102.0,262,1,25.5,4,4,4,12,Bronze
17105.0,160,90,665.7799999999999,4,2,3,9,Silver
17107.0,34,416,10797.48,2,1,1,4,Platinum
17109.0,30,116,881.29,2,1,2,5,Platinum
17110.0,166,12,163.3,4,4,4,12,Bronze
17111.0,48,29,231.60999999999999,2,3,4,9,Silver
17114.0,6,123,801.12,1,1,2,4,Platinum
17115.0,9,39,837.4999999999997,1,3,2,6,Gold
17117.0,289,9,116.19999999999999,4,4,4,12,Bronze
17118.0,318,10,157.02,4,4,4,12,Bronze
17119.0,4,35,606.91,1,3,3,7,Gold
17120.0,234,18,307.46000000000004,4,3,3,10,Silver
17122.0,120,7,138.32,3,4,4,11,Bronze
17123.0,162,9,345.29999999999995,4,4,3,11,Bronze
17124.0,186,31,294.24,4,3,4,11,Bronze
17125.0,51,35,230.5,2,3,4,9,Silver
17126.0,153,248,989.45,4,1,2,7,Gold
17128.0,335,14,157.08999999999997,4,4,4,12,Bronze
17131.0,6,134,2463.17,1,1,1,3,Platinum
17133.0,16,27,4892.240000000001,1,3,1,5,Platinum
17134.0,107,23,413.2,3,3,3,9,Silver
17135.0,17,52,1139.73,1,2,2,5,Platinum
17138.0,276,24,380.5,4,3,3,10,Silver
17139.0,16,477,10650.77,1,1,1,3,Platinum
17140.0,248,18,454.12,4,3,3,10,Silver
17142.0,240,15,578.9999999999999,4,4,3,11,Bronze
17144.0,2,48,984.5699999999999,1,2,2,5,Platinum
17146.0,106,35,749.78,3,3,2,8,Gold
17147.0,23,81,1714.59,2,2,1,5,Platinum
17148.0,52,9,124.88,3,4,4,11,Bronze
17152.0,195,14,1689.5,4,4,1,9,Silver
17153.0,25,14,213.77999999999997,2,4,4,10,Silver
17154.0,76,23,329.34,3,3,3,9,Silver
17155.0,18,20,251.69999999999993,1,3,4,8,Gold
17157.0,8,13,319.0,1,4,3,8,Gold
17158.0,33,67,1266.97,2,2,2,6,Gold
17159.0,22,101,1538.88,2,1,2,5,Platinum
17160.0,32,229,3518.0299999999997,2,1,1,4,Platinum
17162.0,29,104,1715.46,2,1,1,4,Platinum
17163.0,22,5,293.1,2,4,4,10,Silver
17164.0,33,144,2467.35,2,1,1,4,Platinum
17165.0,285,10,158.68,4,4,4,12,Bronze
17166.0,39,12,206.33999999999997,2,4,4,10,Silver
17169.0,58,54,835.7800000000002,3,2,2,7,Gold
17171.0,290,16,224.91,4,4,4,12,Bronze
17172.0,79,15,317.76,3,4,3,10,Silver
17173.0,6,86,3766.5999999999995,1,2,1,4,Platinum
17174.0,218,4,59.9,4,4,4,12,Bronze
17175.0,45,63,1443.69,2,2,2,6,Gold
17176.0,202,15,306.13,4,4,4,12,Bronze
17179.0,179,80,711.79,4,2,2,8,Gold
17180.0,57,125,783.9700000000003,3,1,2,6,Gold
17181.0,58,23,239.91999999999996,3,3,4,10,Silver
17183.0,8,73,3347.31,1,2,1,4,Platinum
17186.0,47,2,144.0,2,4,4,10,Silver
17187.0,227,10,203.95,4,4,4,12,Bronze
17188.0,12,84,2474.23,1,2,1,4,Platinum
17189.0,107,60,383.75000000000006,3,2,3,8,Gold
17190.0,59,19,444.74,3,3,3,9,Silver
17191.0,29,236,2093.68,2,1,1,4,Platinum
17193.0,36,32,1699.3000000000002,2,3,1,6,Gold
17194.0,274,29,262.62,4,3,4,11,Bronze
17197.0,30,29,1013.01,2,3,2,7,Gold
17198.0,24,96,692.2199999999999,2,2,2,6,Gold
17201.0,54,38,289.78000000000003,3,3,4,10,Silver
17203.0,36,148,3560.08,2,1,1,4,Platinum
17204.0,176,57,1564.56,4,2,2,8,Gold
17205.0,54,13,384.08,3,4,3,10,Silver
17206.0,54,7,204.24,3,4,4,11,Bronze
17211.0,27,211,2317.2200000000003,2,1,1,4,Platinum
17212.0,254,4,226.85,4,4,4,12,Bronze
17213.0,41,157,2781.2300000000005,2,1,1,4,Platinum
17214.0,61,101,1059.12,3,1,2,6,Gold
17217.0,235,9,113.49999999999999,4,4,4,12,Bronze
17218.0,5,271,1951.97,1,1,1,3,Platinum
17219.0,32,25,114.23,2,3,4,9,Silver
17220.0,25,467,3187.5499999999997,2,1,1,4,Platinum
17221.0,8,62,334.48,1,2,3,6,Gold
17222.0,66,27,328.65,3,3,3,9,Silver
17223.0,311,48,416.89,4,2,3,9,Silver
17226.0,309,21,393.48999999999995,4,3,3,10,Silver
17227.0,19,47,939.3199999999999,2,2,2,6,Gold
17228.0,16,208,1906.09,1,1,1,3,Platinum
17229.0,97,47,318.76000000000005,3,2,3,8,Gold
17230.0,265,69,3638.41,4,2,1,7,Gold
17231.0,13,531,3124.72,1,1,1,3,Platinum
17232.0,3,35,417.77,1,3,3,7,Gold
17233.0,36,25,190.88,2,3,4,9,Silver
17234.0,183,14,149.89,4,4,4,12,Bronze
17235.0,26,29,550.0600000000002,2,3,3,8,Gold
17236.0,13,105,916.1300000000001,1,1,2,4,Platinum
17237.0,12,19,314.69,1,3,3,7,Gold
17238.0,3,555,3719.1000000000004,1,1,1,3,Platinum
17239.0,313,15,382.50000000000006,4,4,3,11,Bronze
17242.0,109,40,1135.04,3,3,2,8,Gold
17243.0,2,387,8540.05,1,1,1,3,Platinum
17244.0,54,31,954.9,3,3,2,8,Gold
17245.0,205,9,171.45,4,4,4,12,Bronze
17247.0,16,54,280.09000000000003,1,2,4,7,Gold
17248.0,121,69,318.65000000000003,3,2,3,8,Gold
17250.0,4,56,381.97,1,2,3,6,Gold
17251.0,363,37,269.83000000000004,4,3,4,11,Bronze
17252.0,117,86,348.90999999999997,3,2,3,8,Gold
17253.0,19,18,178.26,2,3,4,9,Silver
17254.0,5,111,271.19,1,1,4,6,Gold
17255.0,41,74,291.47999999999996,2,2,4,8,Gold
17256.0,108,16,240.0,3,4,4,11,Bronze
17259.0,149,116,581.2299999999999,4,1,3,8,Gold
17262.0,53,12,1253.3600000000001,3,4,2,9,Silver
17263.0,209,23,63.440000000000005,4,3,4,11,Bronze
17265.0,139,122,550.0100000000001,3,1,3,7,Gold
17266.0,3,73,296.58,1,2,4,7,Gold
17267.0,128,37,317.2,3,3,3,9,Silver
17268.0,108,6,763.64,3,4,2,9,Silver
17272.0,43,114,2148.6300000000006,2,1,1,4,Platinum
17274.0,36,25,107.82,2,3,4,9,Silver
17277.0,228,69,1065.3500000000001,4,2,2,8,Gold
17278.0,242,15,246.04000000000002,4,4,4,12,Bronze
17279.0,58,9,187.82999999999998,3,4,4,11,Bronze
17282.0,131,89,1685.46,3,2,1,6,Gold
17284.0,61,291,1647.48,3,1,2,6,Gold
17286.0,22,44,151.37,2,2,4,8,Gold
17287.0,27,122,1049.0600000000002,2,1,2,5,Platinum
17288.0,10,140,1417.63,1,1,2,4,Platinum
17289.0,32,104,931.02,2,1,2,5,Platinum
17290.0,4,96,513.01,1,2,3,6,Gold
17291.0,309,1,550.8000000000001,4,4,3,11,Bronze
17293.0,9,132,1854.06,1,1,1,3,Platinum
17295.0,29,68,547.0,2,2,3,7,Gold
17297.0,18,49,128.18,1,2,4,7,Gold
17298.0,102,30,498.42,3,3,3,9,Silver
17299.0,12,55,656.61,1,2,3,6,Gold
17301.0,22,59,163.24,2,2,4,8,Gold
17302.0,15,79,1135.63,1,2,2,5,Platinum
17303.0,362,53,250.03999999999996,4,2,4,10,Silver
17306.0,11,66,8631.310000000001,1,2,1,4,Platinum
17309.0,96,12,82.75,3,4,4,11,Bronze
17311.0,79,55,1384.85,3,2,2,7,Gold
17312.0,139,14,644.3,3,4,3,10,Silver
17313.0,32,24,2328.84,2,3,1,6,Gold
17314.0,25,131,2527.92,2,1,1,4,Platinum
17315.0,2,471,6281.23,1,1,1,3,Platinum
17317.0,47,9,2600.34,2,4,1,7,Gold
17320.0,101,73,1200.6200000000001,3,2,2,7,Gold
17321.0,9,99,657.16,1,1,3,5,Platinum
17323.0,16,195,906.52,1,1,2,4,Platinum
17324.0,18,49,986.4799999999999,1,2,2,5,Platinum
17325.0,281,6,96.8,4,4,4,12,Bronze
17329.0,15,33,523.11,1,3,3,7,Gold
17330.0,23,6,363.9,2,4,3,9,Silver
17331.0,124,1,175.2,3,4,4,11,Bronze
17333.0,86,28,494.25,3,3,3,9,Silver
17334.0,303,11,307.02000000000004,4,4,3,11,Bronze
17337.0,152,521,1981.06,4,1,1,6,Gold
17338.0,18,721,6493.54,1,1,1,3,Platinum
17339.0,95,9,243.36,3,4,4,11,Bronze
17340.0,30,407,12353.29,2,1,1,4,Platinum
17341.0,157,157,682.29,4,1,2,7,Gold
17343.0,356,17,193.64,4,4,4,12,Bronze
17344.0,47,31,157.61999999999998,2,3,4,9,Silver
17345.0,16,83,519.69,1,2,3,6,Gold
17346.0,4,483,2622.88,1,1,1,3,Platinum
17347.0,87,1,228.96,3,4,4,11,Bronze
17348.0,15,213,1156.6,1,1,2,4,Platinum
17349.0,180,8,98.25,4,4,4,12,Bronze
17350.0,9,70,1281.3200000000004,1,2,2,5,Platinum
17351.0,37,27,587.15,2,3,3,8,Gold
17353.0,130,8,1740.0,3,4,1,8,Gold
17354.0,51,16,1393.06,2,4,2,8,Gold
17356.0,312,19,178.21999999999997,4,3,4,11,Bronze
17357.0,25,44,384.39,2,2,3,7,Gold
17358.0,304,58,360.80999999999995,4,2,3,9,Silver
17359.0,12,15,127.85999999999999,1,4,4,9,Silver
17360.0,18,125,568.2400000000001,1,1,3,5,Platinum
17361.0,50,29,488.20000000000005,2,3,3,8,Gold
17362.0,240,35,312.22999999999996,4,3,3,10,Silver
17364.0,1,406,4462.68,1,1,1,3,Platinum
17365.0,13,465,4767.360000000001,1,1,1,3,Platinum
17367.0,239,33,167.54999999999998,4,3,4,11,Bronze
17368.0,24,107,1878.8700000000001,2,1,1,4,Platinum
17370.0,73,33,446.17999999999995,3,3,3,9,Silver
17371.0,18,86,418.40000000000003,1,2,3,6,Gold
17372.0,41,251,1337.18,2,1,2,5,Platinum
17373.0,41,57,646.9200000000001,2,2,3,7,Gold
17374.0,219,28,495.7699999999999,4,3,3,10,Silver
17375.0,200,69,400.09999999999997,4,2,3,9,Silver
17376.0,71,24,203.2,3,3,4,10,Silver
17377.0,24,404,4058.32,2,1,1,4,Platinum
17379.0,12,78,389.72,1,2,3,6,Gold
17381.0,9,109,20275.61,1,1,1,3,Platinum
17382.0,66,2,65.4,3,4,4,11,Bronze
17383.0,5,49,193.39,1,2,4,7,Gold
17384.0,20,15,336.4,2,4,3,9,Silver
17385.0,15,45,256.11,1,2,4,7,Gold
17386.0,8,28,2686.4200000000005,1,3,1,5,Platinum
17387.0,20,76,746.81,2,2,2,6,Gold
17388.0,78,15,1259.5600000000002,3,4,2,9,Silver
17389.0,1,213,31833.68,1,1,1,3,Platinum
17391.0,164,3,508.8,4,4,3,11,Bronze
17392.0,307,56,417.27,4,2,3,9,Silver
17394.0,220,4,203.86999999999995,4,4,4,12,Bronze
17396.0,40,27,7330.8,2,3,1,6,Gold
17397.0,23,89,681.41,2,2,2,6,Gold
17398.0,115,38,653.38,3,3,3,9,Silver
17400.0,127,206,2097.84,3,1,1,5,Platinum
17402.0,5,59,2633.8499999999995,1,2,1,4,Platinum
17403.0,37,32,263.92,2,3,4,9,Silver
17404.0,5,198,31906.819999999996,1,1,1,3,Platinum
17405.0,2,82,1031.41,1,2,2,5,Platinum
17406.0,334,111,2184.42,4,1,1,6,Gold
17408.0,164,2,32.65,4,4,4,12,Bronze
17409.0,185,13,771.8499999999999,4,4,2,10,Silver
17410.0,17,64,1214.72,1,2,2,5,Platinum
17411.0,13,41,778.9399999999999,1,3,2,6,Gold
17412.0,3,66,1258.0600000000002,1,2,2,5,Platinum
17414.0,44,6,778.0,2,4,2,8,Gold
17415.0,80,14,507.8399999999999,3,4,3,10,Silver
17416.0,30,269,6893.42,2,1,1,4,Platinum
17418.0,43,30,463.46,2,3,3,8,Gold
17419.0,12,206,4226.57,1,1,1,3,Platinum
17420.0,51,30,598.83,2,3,3,8,Gold
17422.0,17,117,1979.3700000000001,1,1,1,3,Platinum
17423.0,47,26,698.41,2,3,2,7,Gold
17425.0,20,43,759.1700000000001,2,2,2,6,Gold
17426.0,9,271,5037.26,1,1,1,3,Platinum
17427.0,72,2,100.8,3,4,4,11,Bronze
17428.0,1,328,17256.85,1,1,1,3,Platinum
17429.0,129,39,524.9200000000001,3,3,3,9,Silver
17430.0,33,14,265.76000000000005,2,4,4,10,Silver
17431.0,314,43,403.3,4,2,3,9,Silver
17432.0,19,48,365.76,2,2,3,7,Gold
17433.0,89,54,303.15999999999997,3,2,4,9,Silver
17434.0,3,134,2373.8199999999997,1,1,1,3,Platinum
17436.0,2,9,216.3,1,4,4,9,Silver
17438.0,254,17,388.45000000000005,4,4,3,11,Bronze
17440.0,157,5,186.42,4,4,4,12,Bronze
17442.0,37,135,2248.56,2,1,1,4,Platinum
17443.0,220,1,534.24,4,4,3,11,Bronze
17444.0,148,135,2940.04,4,1,1,6,Gold
17446.0,177,9,120.90000000000002,4,4,4,12,Bronze
17447.0,41,36,541.53,2,3,3,8,Gold
17449.0,3,276,2519.21,1,1,1,3,Platinum
17450.0,9,336,194390.78999999998,1,1,1,3,Platinum
17451.0,2,100,1721.4,1,1,1,3,Platinum
17453.0,18,19,486.71999999999997,1,3,3,7,Gold
17454.0,193,61,517.53,4,2,3,9,Silver
17455.0,204,8,131.7,4,4,4,12,Bronze
17456.0,366,17,249.86,4,4,4,12,Bronze
17457.0,127,19,1737.7,3,3,1,7,Gold
17458.0,16,54,316.49999999999994,1,2,3,6,Gold
17459.0,44,111,657.3,2,1,3,6,Gold
17460.0,95,29,622.43,3,3,3,9,Silver
17461.0,23,106,735.82,2,1,2,5,Platinum
17462.0,61,27,675.6899999999999,3,3,2,8,Gold
17463.0,17,208,1875.86,1,1,1,3,Platinum
17464.0,159,9,289.96000000000004,4,4,4,12,Bronze
17466.0,11,41,763.28,1,3,2,6,Gold
17468.0,11,5,137.0,1,4,4,9,Silver
17469.0,17,88,1870.9700000000003,1,2,1,4,Platinum
17470.0,45,78,1125.0700000000002,2,2,2,6,Gold
17472.0,192,174,697.5400000000001,4,1,2,7,Gold
17475.0,80,14,194.36999999999995,3,4,4,11,Bronze
17480.0,78,29,511.82,3,3,3,9,Silver
17481.0,4,82,1255.59,1,2,2,5,Platinum
17483.0,66,21,414.04,3,3,3,9,Silver
17486.0,262,24,396.87,4,3,3,10,Silver
17489.0,59,29,376.63999999999993,3,3,3,9,Silver
17490.0,1,76,2092.32,1,2,1,4,Platinum
17491.0,2,109,3558.8700000000003,1,1,1,3,Platinum
17492.0,249,12,374.57,4,4,3,11,Bronze
17495.0,8,27,497.56000000000006,1,3,3,7,Gold
17496.0,359,10,271.05,4,4,4,12,Bronze
17498.0,76,17,272.22,3,4,4,11,Bronze
17499.0,290,40,622.88,4,3,3,10,Silver
17500.0,18,5,1138.0,1,4,2,7,Gold
17501.0,221,18,288.59999999999997,4,3,4,11,Bronze
17502.0,10,28,689.0999999999999,1,3,2,6,Gold
17503.0,3,38,558.9599999999999,1,3,3,7,Gold
17504.0,207,127,2997.03,4,1,1,6,Gold
17505.0,162,52,1145.84,4,2,2,8,Gold
17506.0,76,14,302.20000000000005,3,4,4,11,Bronze
17507.0,262,88,605.58,4,2,3,9,Silver
17508.0,281,22,387.31,4,3,3,10,Silver
17509.0,58,364,6083.639999999999,3,1,1,5,Platinum
17510.0,25,20,308.48,2,3,3,8,Gold
17511.0,3,963,91062.38,1,1,1,3,Platinum
17512.0,29,105,2924.99,2,1,1,4,Platinum
17513.0,73,6,513.2,3,4,3,10,Silver
17514.0,129,40,208.65,3,3,4,10,Silver
17515.0,32,87,639.02,2,2,3,7,Gold
17516.0,16,135,764.8799999999999,1,1,2,4,Platinum
17517.0,309,11,153.94,4,4,4,12,Bronze
17519.0,18,82,1844.02,1,2,1,4,Platinum
17520.0,54,30,546.81,3,3,3,9,Silver
17521.0,30,45,723.21,2,2,2,6,Gold
17522.0,2,73,1070.71,1,2,2,5,Platinum
17523.0,12,33,652.74,1,3,3,7,Gold
17524.0,362,6,145.0,4,4,4,12,Bronze
17525.0,360,9,422.7,4,4,3,11,Bronze
17526.0,5,19,1195.9,1,3,2,6,Gold
17527.0,54,47,939.37,3,2,2,7,Gold
17528.0,2,253,3628.5,1,1,1,3,Platinum
17530.0,2,390,2367.12,1,1,1,3,Platinum
17531.0,191,14,296.7,4,4,4,12,Bronze
17534.0,54,9,223.36,3,4,4,11,Bronze
17535.0,281,13,164.39999999999998,4,4,4,12,Bronze
17536.0,178,3,76.5,4,4,4,12,Bronze
17537.0,30,74,887.67,2,2,2,6,Gold
17538.0,26,9,98.42,2,4,4,10,Silver
17540.0,25,25,578.9,2,3,3,8,Gold
17542.0,270,25,170.75,4,3,4,11,Bronze
17545.0,44,141,642.3199999999999,2,1,3,6,Gold
17548.0,234,5,103.3,4,4,4,12,Bronze
17549.0,24,6,148.86,2,4,4,10,Silver
17550.0,198,42,267.1600000000001,4,2,4,10,Silver
17551.0,360,39,290.34,4,3,4,11,Bronze
17552.0,61,49,930.41,3,2,2,7,Gold
17553.0,130,2,1487.6,3,4,2,9,Silver
17554.0,2,88,1952.4499999999998,1,2,1,4,Platinum
17555.0,20,105,480.31,2,1,3,6,Gold
17556.0,206,6,157.9,4,4,4,12,Bronze
17557.0,15,34,541.4599999999999,1,3,3,7,Gold
17560.0,95,26,854.95,3,3,2,8,Gold
17561.0,20,45,165.11999999999998,2,2,4,8,Gold
17562.0,15,63,1122.3799999999999,1,2,2,5,Platinum
17564.0,25,49,454.01,2,2,3,7,Gold
17566.0,9,142,869.77,1,1,2,4,Platinum
17567.0,8,165,4331.48,1,1,1,3,Platinum
17569.0,333,29,344.13999999999993,4,3,3,10,Silver
17571.0,51,271,1425.67,2,1,2,5,Platinum
17572.0,72,12,226.75,3,4,4,11,Bronze
17573.0,30,25,380.59999999999997,2,3,3,8,Gold
17574.0,243,8,185.64999999999998,4,4,4,12,Bronze
17576.0,9,402,3564.83,1,1,1,3,Platinum
17578.0,219,5,143.45999999999998,4,4,4,12,Bronze
17579.0,5,50,448.8999999999999,1,2,3,6,Gold
17580.0,253,45,215.71999999999997,4,2,4,10,Silver
17581.0,1,439,11025.24,1,1,1,3,Platinum
17582.0,237,29,175.27,4,3,4,11,Bronze
17584.0,8,35,1242.3000000000002,1,3,2,6,Gold
17585.0,110,208,1116.68,3,1,2,6,Gold
17588.0,101,23,1240.2,3,3,2,8,Gold
17589.0,61,253,2404.17,3,1,1,5,Platinum
17590.0,3,196,1468.02,1,1,2,4,Platinum
17591.0,74,157,2203.67,3,1,1,5,Platinum
17593.0,4,212,3923.86,1,1,1,3,Platinum
17594.0,86,50,993.1800000000001,3,2,2,7,Gold
17595.0,13,82,386.69000000000005,1,2,3,6,Gold
17596.0,24,265,2806.69,2,1,1,4,Platinum
17597.0,214,55,2044.37,4,2,1,7,Gold
17600.0,18,13,161.67000000000002,1,4,4,9,Silver
17601.0,240,9,116.00999999999999,4,4,4,12,Bronze
17602.0,3,551,5054.42,1,1,1,3,Platinum
17603.0,79,11,394.71999999999997,3,4,3,10,Silver
17604.0,218,63,309.35999999999996,4,2,3,9,Silver
17608.0,34,56,191.99,2,2,4,8,Gold
17609.0,41,233,1105.78,2,1,2,5,Platinum
17611.0,8,567,3961.12,1,1,1,3,Platinum
17612.0,54,135,2048.45,3,1,1,5,Platinum
17613.0,23,306,4544.55,2,1,1,4,Platinum
17614.0,58,98,386.32,3,2,3,8,Gold
17615.0,131,14,329.6000000000001,3,4,3,10,Silver
17616.0,174,3,571.2,4,4,3,11,Bronze
17618.0,6,67,930.2800000000001,1,2,2,5,Platinum
17619.0,313,74,214.36999999999998,4,2,4,10,Silver
17620.0,60,4,81.44,3,4,4,11,Bronze
17621.0,22,26,1379.8999999999999,2,3,2,7,Gold
17623.0,33,33,527.0500000000001,2,3,3,8,Gold
17624.0,15,50,843.48,1,2,2,5,Platinum
17625.0,19,306,2020.4,2,1,1,4,Platinum
17628.0,82,5,75.75000000000001,3,4,4,11,Bronze
17629.0,6,123,1814.12,1,1,1,3,Platinum
17630.0,170,26,503.59999999999997,4,3,3,10,Silver
17631.0,2,39,528.3300000000002,1,3,3,7,Gold
17633.0,32,70,1324.8400000000001,2,2,2,6,Gold
17634.0,37,296,2358.59,2,1,1,4,Platinum
17636.0,20,20,285.55999999999995,2,3,4,9,Silver
17637.0,32,35,547.0600000000001,2,3,3,8,Gold
17639.0,277,7,108.5,4,4,4,12,Bronze
17640.0,87,5,621.6600000000001,3,4,3,10,Silver
17642.0,120,40,712.29,3,3,2,8,Gold
17643.0,374,8,101.55,4,4,4,12,Bronze
17644.0,2,157,2895.64,1,1,1,3,Platinum
17646.0,220,51,1008.39,4,2,2,8,Gold
17647.0,66,7,133.06,3,4,4,11,Bronze
17648.0,61,91,1797.5,3,2,1,6,Gold
17649.0,139,52,868.49,3,2,2,7,Gold
17650.0,22,8,166.07999999999998,2,4,4,10,Silver
17651.0,12,232,3945.0,1,1,1,3,Platinum
17652.0,26,259,4867.72,2,1,1,4,Platinum
17653.0,37,44,1207.56,2,2,2,6,Gold
17654.0,278,22,117.55000000000001,4,3,4,11,Bronze
17655.0,11,91,2638.9400000000005,1,2,1,4,Platinum
17656.0,74,82,1674.6900000000003,3,2,1,6,Gold
17658.0,26,19,595.42,2,3,3,8,Gold
17659.0,18,158,2999.46,1,1,1,3,Platinum
17660.0,142,38,178.75000000000003,3,3,4,10,Silver
17663.0,26,86,1802.9100000000003,2,2,1,5,Platinum
17664.0,19,43,604.64,2,2,3,7,Gold
17666.0,4,18,728.1599999999999,1,3,2,6,Gold
17667.0,67,116,2055.51,3,1,1,5,Platinum
17668.0,2,15,347.75,1,4,3,8,Gold
17669.0,43,68,3406.72,2,2,1,5,Platinum
17670.0,228,11,205.7,4,4,4,12,Bronze
17671.0,16,53,1572.7100000000003,1,2,2,5,Platinum
17672.0,51,110,3178.17,2,1,1,4,Platinum
17673.0,2,218,1594.9699999999998,1,1,2,4,Platinum
17674.0,75,27,551.0400000000001,3,3,3,9,Silver
17675.0,2,705,20374.28,1,1,1,3,Platinum
17676.0,5,77,1371.18,1,2,2,5,Platinum
17677.0,2,303,16345.38,1,1,1,3,Platinum
17678.0,264,16,298.11,4,4,4,12,Bronze
17679.0,53,30,1992.1100000000001,3,3,1,7,Gold
17680.0,24,11,184.39999999999998,2,4,4,10,Silver
17682.0,11,118,2474.3299999999995,1,1,1,3,Platinum
17684.0,44,15,239.41,2,4,4,10,Silver
17685.0,17,127,3155.8299999999995,1,1,1,3,Platinum
17686.0,8,286,5739.460000000001,1,1,1,3,Platinum
17690.0,31,252,4726.8,2,1,1,4,Platinum
17691.0,359,19,290.4,4,3,4,11,Bronze
17692.0,128,46,740.9399999999998,3,2,2,7,Gold
17693.0,138,16,200.46999999999997,3,4,4,11,Bronze
17694.0,142,15,283.12,3,4,4,11,Bronze
17695.0,132,35,765.3400000000001,3,3,2,8,Gold
17696.0,39,115,2285.7100000000005,2,1,1,4,Platinum
17697.0,237,19,338.95000000000005,4,3,3,10,Silver
17698.0,261,8,154.95,4,4,4,12,Bronze
17700.0,17,142,2534.64,1,1,1,3,Platinum
17701.0,253,24,417.95000000000005,4,3,3,10,Silver
17702.0,31,74,1824.37,2,2,1,5,Platinum
17703.0,36,55,798.74,2,2,2,6,Gold
17704.0,169,31,885.1899999999999,4,3,2,9,Silver
17705.0,4,103,1823.52,1,1,1,3,Platinum
17706.0,5,382,10504.49,1,1,1,3,Platinum
17707.0,186,5,152.39999999999998,4,4,4,12,Bronze
17708.0,188,34,263.33,4,3,4,11,Bronze
17709.0,170,7,137.45,4,4,4,12,Bronze
17711.0,11,23,385.1,1,3,3,7,Gold
17712.0,45,29,522.91,2,3,3,8,Gold
17714.0,321,10,153.0,4,4,4,12,Bronze
17715.0,201,1,326.4,4,4,3,11,Bronze
17716.0,23,245,5655.99,2,1,1,4,Platinum
17718.0,233,6,139.35,4,4,4,12,Bronze
17719.0,38,274,5396.04,2,1,1,4,Platinum
17720.0,27,50,1195.94,2,2,2,6,Gold
17722.0,97,115,2424.04,3,1,1,5,Platinum
17723.0,128,10,3276.4,3,4,1,8,Gold
17724.0,72,40,1033.0,3,3,2,8,Gold
17725.0,17,192,3439.08,1,1,1,3,Platinum
17727.0,16,66,1060.25,1,2,2,5,Platinum
17728.0,4,165,2876.01,1,1,1,3,Platinum
17730.0,4,218,5298.48,1,1,1,3,Platinum
17731.0,80,67,1240.11,3,2,2,7,Gold
17732.0,373,18,303.96999999999997,4,3,4,11,Bronze
17733.0,39,35,692.1899999999999,2,3,2,7,Gold
17734.0,54,43,700.63,3,2,2,7,Gold
17735.0,3,690,13110.02,1,1,1,3,Platinum
17736.0,10,25,377.44,1,3,3,7,Gold
17737.0,10,10,168.24,1,4,4,9,Silver
17738.0,20,97,1879.05,2,2,1,5,Platinum
17739.0,12,47,2791.3500000000004,1,2,1,4,Platinum
17742.0,114,15,355.11,3,4,3,10,Silver
17744.0,4,136,2322.4,1,1,1,3,Platinum
17746.0,241,6,110.25000000000001,4,4,4,12,Bronze
17747.0,113,1,71.4,3,4,4,11,Bronze
17749.0,179,35,674.52,4,3,2,9,Silver
17750.0,6,184,1710.4499999999998,1,1,1,3,Platinum
17752.0,360,1,80.64,4,4,4,12,Bronze
17754.0,1,89,1664.6499999999999,1,2,1,4,Platinum
17757.0,2,740,5593.39,1,1,1,3,Platinum
17758.0,20,404,3408.2000000000003,2,1,1,4,Platinum
17759.0,18,90,819.96,1,2,2,5,Platinum
17760.0,22,25,287.59000000000003,2,3,4,9,Silver
17761.0,33,19,712.78,2,3,2,7,Gold
17763.0,264,1,15.0,4,4,4,12,Bronze
17764.0,51,71,772.5500000000001,2,2,2,6,Gold
17765.0,159,56,367.63,4,2,3,9,Silver
17767.0,16,21,271.20000000000005,1,3,4,8,Gold
17768.0,9,98,2081.9,1,2,1,4,Platinum
17769.0,13,304,3957.43,1,1,1,3,Platinum
17770.0,199,38,1143.2699999999998,4,3,2,9,Silver
17771.0,57,54,245.81000000000003,3,2,4,9,Silver
17772.0,11,50,173.45,1,2,4,7,Gold
17774.0,97,153,1213.73,3,1,2,6,Gold
17775.0,255,3,56.4,4,4,4,12,Bronze
17777.0,25,190,647.56,2,1,3,6,Gold
17779.0,22,81,650.32,2,2,3,7,Gold
17781.0,160,12,188.01999999999998,4,4,4,12,Bronze
17783.0,73,67,283.4699999999999,3,2,4,9,Silver
17785.0,54,13,131.94,3,4,4,11,Bronze
17786.0,86,68,266.8500000000001,3,2,4,9,Silver
17787.0,153,128,1817.54,4,1,1,6,Gold
17788.0,74,5,1117.9,3,4,2,9,Silver
17789.0,282,14,225.9,4,4,4,12,Bronze
17790.0,27,189,1964.3000000000002,2,1,1,4,Platinum
17791.0,30,10,106.1,2,4,4,10,Silver
17793.0,26,52,300.34,2,2,4,8,Gold
17795.0,180,45,342.82999999999987,4,2,3,9,Silver
17796.0,41,81,690.0,2,2,2,6,Gold
17797.0,23,111,780.4300000000002,2,1,2,5,Platinum
17799.0,23,404,3039.17,2,1,1,4,Platinum
17800.0,38,103,1187.21,2,1,2,5,Platinum
17802.0,83,140,1285.04,3,1,2,6,Gold
17805.0,74,10,512.31,3,4,3,10,Silver
17806.0,12,43,546.04,1,2,3,6,Gold
17809.0,17,61,5411.91,1,2,1,4,Platinum
17811.0,5,828,7761.82,1,1,1,3,Platinum
17812.0,13,133,699.81,1,1,2,4,Platinum
17813.0,15,348,1698.0700000000002,1,1,1,3,Platinum
17816.0,37,17,36.559999999999995,2,4,4,10,Silver
17817.0,5,33,387.68,1,3,3,7,Gold
17819.0,72,48,3704.87,3,2,1,6,Gold
17824.0,52,13,298.4,3,4,4,11,Bronze
17827.0,6,215,1987.33,1,1,1,3,Platinum
17828.0,23,67,1820.0900000000001,2,2,1,5,Platinum
17829.0,299,30,889.24,4,3,2,9,Silver
17830.0,2,23,398.69999999999993,1,3,3,7,Gold
17831.0,34,2,35.400000000000006,2,4,4,10,Silver
17832.0,50,61,155.37000000000003,2,2,4,8,Gold
17835.0,3,59,342.23999999999995,1,2,3,6,Gold
17836.0,48,24,110.21,2,3,4,9,Silver
17837.0,43,162,1541.23,2,1,2,5,Platinum
17838.0,27,117,2720.8,2,1,1,4,Platinum
17839.0,43,52,318.15000000000003,2,2,3,7,Gold
17841.0,2,7676,40519.840000000004,1,1,1,3,Platinum
17843.0,304,37,205.48000000000002,4,3,4,11,Bronze
17844.0,107,5,51.56,3,4,4,11,Bronze
17846.0,86,1,2033.1,3,4,1,8,Gold
17848.0,82,51,901.2,3,2,2,7,Gold
17849.0,219,26,605.8000000000001,4,3,3,10,Silver
17850.0,373,297,5391.210000000001,4,1,1,6,Gold
17852.0,12,24,114.34,1,3,4,8,Gold
17854.0,186,15,311.26,4,4,3,11,Bronze
17855.0,373,17,208.97,4,4,4,12,Bronze
17856.0,2,15,1418.0300000000002,1,4,2,7,Gold
17857.0,5,54,26879.04,1,2,1,4,Platinum
17858.0,6,197,5140.66,1,1,1,3,Platinum
17859.0,305,23,141.92000000000002,4,3,4,11,Bronze
17860.0,369,52,226.45,4,2,4,10,Silver
17861.0,4,219,2097.88,1,1,1,3,Platinum
17862.0,324,11,330.9,4,4,3,11,Bronze
17863.0,60,148,3160.0,3,1,1,5,Platinum
17864.0,13,90,554.85,1,2,3,6,Gold
17865.0,31,370,10526.32,2,1,1,4,Platinum
17866.0,143,9,329.65,4,4,3,11,Bronze
17867.0,31,68,1157.8700000000001,2,2,2,6,Gold
17869.0,108,40,428.18,3,3,3,9,Silver
17870.0,3,270,1865.8899999999999,1,1,1,3,Platinum
17871.0,205,10,155.90000000000003,4,4,4,12,Bronze
17873.0,81,43,1848.9600000000005,3,2,1,6,Gold
17874.0,186,46,683.4600000000002,4,2,2,8,Gold
17877.0,171,12,237.61,4,4,4,12,Bronze
17878.0,44,26,379.45,2,3,3,8,Gold
17879.0,174,6,178.51999999999998,4,4,4,12,Bronze
17880.0,365,26,458.91999999999996,4,3,3,10,Silver
17881.0,305,8,133.35000000000002,4,4,4,12,Bronze
17883.0,4,142,664.34,1,1,3,5,Platinum
17884.0,4,113,695.07,1,1,2,4,Platinum
17885.0,13,53,156.34,1,2,4,7,Gold
17886.0,32,102,869.28,2,1,2,5,Platinum
17887.0,130,10,111.35,3,4,4,11,Bronze
17888.0,22,65,716.0,2,2,2,6,Gold
17889.0,213,20,201.37,4,3,4,11,Bronze
17890.0,323,91,586.8900000000001,4,2,3,9,Silver
17891.0,163,34,203.85999999999996,4,3,4,11,Bronze
17892.0,57,28,244.10000000000002,3,3,4,10,Silver
17893.0,226,15,107.21000000000002,4,4,4,12,Bronze
17894.0,72,192,1118.96,3,1,2,6,Gold
17895.0,45,15,95.44999999999999,2,4,4,10,Silver
17896.0,24,2,256.32,2,4,4,10,Silver
17897.0,173,108,541.8100000000002,4,1,3,8,Gold
17898.0,86,28,152.06,3,3,4,10,Silver
17899.0,160,31,154.55,4,3,4,11,Bronze
17900.0,191,6,112.19999999999999,4,4,4,12,Bronze
17901.0,30,19,110.38,2,3,4,9,Silver
17904.0,22,34,181.07,2,3,4,9,Silver
17905.0,72,33,798.99,3,3,2,8,Gold
17906.0,248,12,72.9,4,4,4,12,Bronze
17908.0,374,54,232.02999999999994,4,2,4,10,Silver
17911.0,10,39,366.23,1,3,3,7,Gold
17912.0,311,37,310.06,4,3,3,10,Silver
17913.0,59,58,408.65,3,2,3,8,Gold
17914.0,4,75,329.35999999999996,1,2,3,6,Gold
17917.0,46,92,335.03000000000003,2,2,3,7,Gold
17919.0,89,23,1304.0400000000002,3,3,2,8,Gold
17920.0,5,665,4119.5,1,1,1,3,Platinum
17921.0,65,142,820.2299999999999,3,1,2,6,Gold
17923.0,283,1,207.50000000000003,4,4,4,12,Bronze
17924.0,12,31,2962.500000000001,1,3,1,5,Platinum
17925.0,373,1,244.08,4,4,4,12,Bronze
17926.0,134,21,397.29,3,3,3,9,Silver
17928.0,46,23,212.54000000000002,2,3,4,9,Silver
17929.0,12,5,843.0,1,4,2,7,Gold
17930.0,36,39,1740.4799999999998,2,3,1,6,Gold
17931.0,135,65,408.36,3,2,3,8,Gold
17932.0,30,90,1331.57,2,2,2,6,Gold
17934.0,52,21,704.25,3,3,2,8,Gold
17935.0,139,29,145.79000000000002,3,3,4,10,Silver
17936.0,6,72,380.13,1,2,3,6,Gold
17937.0,9,43,4301.22,1,2,1,4,Platinum
17939.0,160,12,99.14000000000001,4,4,4,12,Bronze
17940.0,50,18,4020.04,2,3,1,6,Gold
17941.0,131,2,304.56,3,4,4,11,Bronze
17942.0,8,2,77.50000000000001,1,4,4,9,Silver
17946.0,234,20,149.58,4,3,4,11,Bronze
17947.0,38,9,176.67999999999998,2,4,4,10,Silver
17948.0,148,1,358.56000000000006,4,4,3,11,Bronze
17949.0,2,70,58510.48000000001,1,2,1,4,Platinum
17950.0,73,71,482.2,3,2,3,8,Gold
17951.0,40,20,1008.5400000000003,2,3,2,7,Gold
17954.0,6,477,2314.1299999999997,1,1,1,3,Platinum
17955.0,199,19,557.3,4,3,3,10,Silver
17956.0,250,1,12.75,4,4,4,12,Bronze
17957.0,67,31,111.67999999999999,3,3,4,10,Silver
17958.0,117,7,508.4599999999999,3,4,3,10,Silver
17960.0,172,26,73.78,4,3,4,11,Bronze
17961.0,22,249,1296.44,2,1,2,5,Platinum
17962.0,143,34,102.41,4,3,4,11,Bronze
17964.0,32,98,463.21,2,2,3,7,Gold
17965.0,38,325,2599.1899999999996,2,1,1,4,Platinum
17966.0,38,68,1098.4299999999998,2,2,2,6,Gold
17967.0,372,42,112.26999999999998,4,2,4,10,Silver
17968.0,374,81,265.09999999999997,4,2,4,10,Silver
17969.0,167,14,228.20000000000002,4,4,4,12,Bronze
17970.0,212,29,562.7900000000001,4,3,3,10,Silver
17972.0,242,30,135.19,4,3,4,11,Bronze
17973.0,52,15,337.03999999999996,3,4,3,10,Silver
17974.0,25,165,703.99,2,1,2,5,Platinum
17975.0,16,293,4483.26,1,1,1,3,Platinum
17976.0,373,57,321.78999999999996,4,2,3,9,Silver
17977.0,30,21,288.14,2,3,4,9,Silver
17978.0,366,12,300.91999999999996,4,4,4,12,Bronze
17979.0,36,138,732.41,2,1,2,5,Platinum
17980.0,166,30,811.45,4,3,2,9,Silver
17984.0,146,48,152.68,4,2,4,10,Silver
17985.0,23,21,631.3499999999999,2,3,3,8,Gold
17986.0,57,1,20.8,3,4,4,11,Bronze
17987.0,186,13,198.57,4,4,4,12,Bronze
17988.0,12,38,201.11999999999998,1,3,4,8,Gold
17990.0,237,29,630.84,4,3,3,10,Silver
17991.0,226,5,93.35,4,4,4,12,Bronze
17994.0,122,79,674.89,3,2,2,7,Gold
17995.0,282,2,76.1,4,4,4,12,Bronze
17997.0,75,164,1962.46,3,1,1,5,Platinum
17999.0,38,91,380.39000000000004,2,2,3,7,Gold
18001.0,13,57,415.13,1,2,3,6,Gold
18004.0,363,37,157.91999999999996,4,3,4,11,Bronze
18005.0,4,53,226.47,1,2,4,7,Gold
18006.0,24,22,444.68,2,3,3,8,Gold
18008.0,71,30,2116.19,3,3,1,7,Gold
18009.0,236,31,247.39000000000001,4,3,4,11,Bronze
18010.0,257,14,174.79999999999998,4,4,4,12,Bronze
18011.0,374,28,102.79,4,3,4,11,Bronze
18013.0,156,31,187.29,4,3,4,11,Bronze
18014.0,29,30,162.22,2,3,4,9,Silver
18015.0,5,46,120.03000000000002,1,2,4,7,Gold
18016.0,33,122,1477.66,2,1,2,5,Platinum
18017.0,82,3,523.0,3,4,3,10,Silver
18018.0,109,29,122.14,3,3,4,10,Silver
18019.0,52,5,38.45,3,4,4,11,Bronze
18022.0,36,164,612.72,2,1,3,6,Gold
18024.0,153,21,389.78,4,3,3,10,Silver
18027.0,99,21,115.30999999999999,3,3,4,10,Silver
18030.0,5,9,230.64999999999998,1,4,4,9,Silver
18032.0,335,5,73.5,4,4,4,12,Bronze
18033.0,66,33,93.82000000000001,3,3,4,10,Silver
18034.0,22,110,418.6799999999999,2,1,3,6,Gold
18035.0,36,49,713.8900000000001,2,2,2,6,Gold
18036.0,33,94,403.12000000000006,2,2,3,7,Gold
18037.0,155,19,70.02,4,3,4,11,Bronze
18040.0,20,19,357.2,2,3,3,8,Gold
18041.0,12,458,4097.37,1,1,1,3,Platinum
18042.0,54,7,165.04999999999998,3,4,4,11,Bronze
18043.0,25,115,529.29,2,1,3,6,Gold
18044.0,5,127,2088.6,1,1,1,3,Platinum
18045.0,46,43,178.33999999999997,2,2,4,8,Gold
18048.0,204,7,172.29000000000002,4,4,4,12,Bronze
18050.0,360,5,74.4,4,4,4,12,Bronze
18053.0,71,20,300.0200000000001,3,3,4,10,Silver
18055.0,8,358,6761.34,1,1,1,3,Platinum
18056.0,289,19,363.65,4,3,3,10,Silver
18058.0,10,3,170.16,1,4,4,9,Silver
18059.0,24,18,306.46,2,3,4,9,Silver
18061.0,22,46,2119.41,2,2,1,5,Platinum
18062.0,174,27,720.5200000000001,4,3,2,9,Silver
18064.0,134,7,814.0,3,4,2,9,Silver
18065.0,6,137,2392.83,1,1,1,3,Platinum
18066.0,76,10,318.0,3,4,3,10,Silver
18067.0,41,37,396.33000000000004,2,3,3,8,Gold
18068.0,290,1,101.69999999999999,4,4,4,12,Bronze
18069.0,27,457,2009.24,2,1,1,4,Platinum
18071.0,258,25,453.0,4,3,3,10,Silver
18072.0,186,18,247.44,4,3,4,11,Bronze
18073.0,115,72,3859.82,3,2,1,6,Gold
18074.0,374,13,489.6,4,4,3,11,Bronze
18075.0,24,142,2611.75,2,1,1,4,Platinum
18077.0,9,223,2584.41,1,1,1,3,Platinum
18078.0,218,29,336.13,4,3,3,10,Silver
18079.0,46,123,3613.1499999999996,2,1,1,4,Platinum
18080.0,19,2,1231.5,2,4,2,8,Gold
18081.0,37,17,343.45,2,4,3,9,Silver
18082.0,26,70,680.8399999999999,2,2,2,6,Gold
18084.0,17,1,90.47999999999999,1,4,4,9,Silver
18085.0,331,29,689.9499999999999,4,3,2,9,Silver
18086.0,275,7,101.33999999999999,4,4,4,12,Bronze
18087.0,99,2,4055.7199999999993,3,4,1,8,Gold
18088.0,62,37,166.02999999999997,3,3,4,10,Silver
18092.0,3,89,9068.26,1,2,1,4,Platinum
18093.0,94,36,2106.52,3,3,1,7,Gold
18094.0,82,70,3017.3,3,2,1,6,Gold
18095.0,313,21,580.05,4,3,3,10,Silver
18096.0,12,196,849.06,1,1,2,4,Platinum
18097.0,8,106,2662.4,1,1,1,3,Platinum
18099.0,128,19,168.31,3,3,4,10,Silver
18101.0,12,40,222.4,1,3,4,8,Gold
18102.0,1,431,259657.3,1,1,1,3,Platinum
18104.0,38,38,754.6400000000001,2,3,2,7,Gold
18105.0,38,18,113.48000000000002,2,3,4,9,Silver
18106.0,330,37,421.9,4,3,3,10,Silver
18108.0,255,17,271.0,4,4,4,12,Bronze
18109.0,2,441,8004.92,1,1,1,3,Platinum
18110.0,20,37,198.8,2,3,4,9,Silver
18112.0,13,26,352.69000000000005,1,3,3,7,Gold
18113.0,369,1,76.32000000000001,4,4,4,12,Bronze
18114.0,291,28,220.1,4,3,4,11,Bronze
18116.0,68,371,1403.1100000000001,3,1,2,6,Gold
18117.0,26,72,315.65,2,2,3,7,Gold
18118.0,11,1263,5625.08,1,1,1,3,Platinum
18119.0,368,29,180.69999999999996,4,3,4,11,Bronze
18120.0,215,17,111.14999999999999,4,4,4,12,Bronze
18121.0,150,31,653.3000000000001,4,3,3,10,Silver
18122.0,9,357,1793.0600000000002,1,1,1,3,Platinum
18123.0,25,34,574.4399999999999,2,3,3,8,Gold
18125.0,30,192,1131.75,2,1,2,5,Platinum
18126.0,61,52,200.92000000000002,3,2,4,9,Silver
18127.0,20,46,347.08,2,2,3,7,Gold
18129.0,244,14,112.55,4,4,4,12,Bronze
18130.0,16,70,1059.3899999999999,1,2,2,5,Platinum
18133.0,213,1,931.4999999999999,4,4,2,10,Silver
18135.0,30,20,681.9100000000001,2,3,2,7,Gold
18136.0,64,38,784.3299999999998,3,3,2,8,Gold
18138.0,296,8,152.65,4,4,4,12,Bronze
18139.0,18,159,8438.34,1,1,1,3,Platinum
18142.0,158,15,1019.52,4,4,2,10,Silver
18143.0,117,61,1000.1600000000001,3,2,2,7,Gold
18144.0,8,43,2888.7500000000005,1,2,1,4,Platinum
18145.0,13,221,2861.55,1,1,1,3,Platinum
18146.0,141,10,160.35,3,4,4,11,Bronze
18147.0,46,7,179.33999999999997,2,4,4,10,Silver
18149.0,51,16,612.0799999999999,2,4,3,9,Silver
18150.0,33,37,566.5800000000002,2,3,3,8,Gold
18151.0,135,38,653.3499999999999,3,3,3,9,Silver
18154.0,4,21,399.18999999999994,1,3,3,7,Gold
18155.0,76,25,371.62000000000006,3,3,3,9,Silver
18156.0,13,122,675.64,1,1,2,4,Platinum
18158.0,10,34,453.4,1,3,3,7,Gold
18159.0,302,23,530.1500000000001,4,3,3,10,Silver
18160.0,58,39,638.0600000000002,3,3,3,9,Silver
18161.0,16,80,1618.69,1,2,2,5,Platinum
18164.0,38,24,399.65,2,3,3,8,Gold
18165.0,178,10,302.46000000000004,4,4,4,12,Bronze
18167.0,24,37,1384.86,2,3,2,7,Gold
18168.0,177,130,1160.04,4,1,2,7,Gold
18169.0,61,9,202.65,3,4,4,11,Bronze
18170.0,34,38,980.3100000000001,2,3,2,7,Gold
18171.0,59,54,1231.31,3,2,2,7,Gold
18172.0,15,189,7561.68,1,1,1,3,Platinum
18173.0,87,31,2106.8400000000006,3,3,1,7,Gold
18174.0,8,1,104.0,1,4,4,9,Silver
18176.0,359,30,476.35,4,3,3,10,Silver
18177.0,32,73,1340.87,2,2,2,6,Gold
18178.0,129,97,1590.81,3,2,2,7,Gold
18179.0,10,90,1793.1700000000003,1,2,1,4,Platinum
18180.0,5,119,1843.7500000000005,1,1,1,3,Platinum
18181.0,25,41,366.84999999999997,2,3,3,8,Gold
18183.0,228,37,632.0700000000002,4,3,3,10,Silver
18184.0,16,1,49.8,1,4,4,9,Silver
18185.0,250,17,304.25,4,4,4,12,Bronze
18188.0,16,71,2001.0399999999997,1,2,1,4,Platinum
18189.0,78,68,1090.2400000000002,3,2,2,7,Gold
18190.0,193,15,284.46,4,4,4,12,Bronze
18191.0,262,7,207.79999999999998,4,4,4,12,Bronze
18192.0,72,45,957.9699999999999,3,2,2,7,Gold
18193.0,166,16,243.76,4,4,4,12,Bronze
18194.0,83,7,973.8399999999999,3,4,2,9,Silver
18196.0,96,139,686.6300000000001,3,1,2,6,Gold
18198.0,5,159,5425.560000000001,1,1,1,3,Platinum
18200.0,107,30,150.35,3,3,4,10,Silver
18202.0,200,68,1396.9900000000002,4,2,2,8,Gold
18203.0,158,19,160.42000000000002,4,3,4,11,Bronze
18204.0,72,192,1975.35,3,1,1,5,Platinum
18205.0,37,32,517.3599999999999,2,3,3,8,Gold
18209.0,29,8,139.10000000000002,2,4,4,10,Silver
18210.0,2,134,2621.38,1,1,1,3,Platinum
18211.0,26,42,600.07,2,2,3,7,Gold
18212.0,327,34,216.07,4,3,4,11,Bronze
18213.0,237,15,232.48000000000002,4,4,4,12,Bronze
18215.0,90,13,299.34,3,4,4,11,Bronze
18216.0,32,26,481.74999999999994,2,3,3,8,Gold
18217.0,30,31,621.7500000000001,2,3,3,8,Gold
18218.0,212,20,641.9200000000001,4,3,3,10,Silver
18219.0,3,114,2069.77,1,1,1,3,Platinum
18220.0,227,2,305.28000000000003,4,4,4,12,Bronze
18221.0,23,64,1041.6100000000001,2,2,2,6,Gold
18222.0,93,19,443.0,3,3,3,9,Silver
18223.0,5,272,6484.54,1,1,1,3,Platinum
18224.0,264,10,158.95000000000002,4,4,4,12,Bronze
18225.0,4,269,5504.960000000001,1,1,1,3,Platinum
18226.0,45,242,5228.050000000001,2,1,1,4,Platinum
18227.0,218,5,93.75,4,4,4,12,Bronze
18228.0,57,30,779.9,3,3,2,8,Gold
18229.0,12,164,7276.9,1,1,1,3,Platinum
18230.0,10,86,2810.1999999999994,1,2,1,4,Platinum
18231.0,193,123,2071.7699999999995,4,1,1,6,Gold
18232.0,82,37,592.97,3,3,3,9,Silver
18233.0,326,1,440.0,4,4,3,11,Bronze
18235.0,72,104,1796.4800000000002,3,1,1,5,Platinum
18236.0,30,49,882.24,2,2,2,6,Gold
18237.0,3,61,987.1000000000001,1,2,2,5,Platinum
18239.0,219,88,1561.6100000000001,4,2,2,8,Gold
18240.0,47,6,422.58000000000004,2,4,3,9,Silver
18241.0,10,104,2073.09,1,1,1,3,Platinum
18242.0,73,78,2232.4900000000002,3,2,1,6,Gold
18245.0,8,175,2567.0600000000004,1,1,1,3,Platinum
18246.0,24,4,596.0999999999999,2,4,3,9,Silver
18248.0,123,47,804.02,3,2,2,7,Gold
18249.0,18,8,95.34,1,4,4,9,Silver
18250.0,311,21,349.27000000000004,4,3,3,10,Silver
18251.0,88,16,4314.72,3,4,1,8,Gold
18252.0,51,94,518.27,2,2,3,7,Gold
18255.0,90,6,103.3,3,4,4,11,Bronze
18257.0,40,118,2337.6300000000006,2,1,1,4,Platinum
18259.0,25,42,2338.6000000000004,2,2,1,5,Platinum
18260.0,173,133,2628.3499999999995,4,1,1,6,Gold
18261.0,44,21,324.24,2,3,3,8,Gold
18262.0,141,13,149.48,3,4,4,11,Bronze
18263.0,26,61,1213.1599999999999,2,2,2,6,Gold
18265.0,73,46,801.5100000000001,3,2,2,7,Gold
18268.0,135,1,25.5,3,4,4,11,Bronze
18269.0,367,7,168.6,4,4,4,12,Bronze
18270.0,39,11,283.15000000000003,2,4,4,10,Silver
18272.0,3,166,3078.58,1,1,1,3,Platinum
18273.0,3,3,204.0,1,4,4,9,Silver
18274.0,31,11,175.92000000000002,2,4,4,10,Silver
18276.0,44,14,335.8599999999999,2,4,3,9,Silver
18277.0,59,8,110.38,3,4,4,11,Bronze
18278.0,74,9,173.89999999999998,3,4,4,11,Bronze
18280.0,278,10,180.6,4,4,4,12,Bronze
18281.0,181,7,80.82,4,4,4,12,Bronze
18282.0,8,12,178.05,1,4,4,9,Silver
18283.0,4,721,2045.53,1,1,1,3,Platinum
18287.0,43,70,1837.2800000000002,2,2,1,5,Platinum
